aachen	ɑː k eː n
abbe	a˧˩ b ɛ˥˩
abbot	a b ɔ t
aboensisk	a b ʊ ɛ n s ɪ s k
abstinens	a b s t ɪ n ɛ n s
abstinensbesvär	a b s t ɪ n ɛ n s b eː s ʋ æː r
accent	a k s a ŋ
accent	a k s ɛ n t
acetylsalicylsyra	a s ɛ t yː l s a l ɪ s yː l s yː r a
ackja	a k j a
ackusativ	a k ɵ s a t iː ʋ
adde	a˧˩ d ɛ˥˩
adel	ɑː d ɛ l
adelssläkt	ɑː˩ d ɛ l s s l ɛ k t
adhd	ɑː d eː h oː d eː
adjektiv	a d j ɛ k t iː ʋ
adjö	a j øː
adla	ɑː d l a
adlig	ɑː d l ɪ ɡ
advent	a d ʋ ɛ n t
adventsljusstake	a d ʋ ɛ˧˩ n t s j ʉː˥˩ s s t ɑː k ɛ
affrikata	a f r ɪ k ɑː t a
afse	a˧˩ f s ɛ˥˩
aftonfalk	a f t ɔ n f a l k
aggressiv	a ɡ r ɛ s iː ʋ
agna	a ɡ n a
agneta	a ɡ n eː˧˩ t a˥˩
agnosticism	a ɡ n ɔ s t ɪ s ɪ s m
agnostiker	a ɡ n ɔ s t ɪ k ɛ r
aioli	a j oː l ɪ
akaciames	a k ɑː s iː j a m eː s
aktie	a k t s ɪ ɛ
aktiebolag	a k t s iː ɛ b ʊ l ɑː ɡ
aktuell	a k t ɵ ɛ l
akut	a k ʉː t
al	ɑː l
albatross	a l b a t r ɔ s
albert	a˥˧ l b æ˩ ʈ
albertina	a l b æ ʈ iː˧˩ n a˥˩
albin	a˥˧ l b ɪ˩ n
aldrig	a l d r iː ɡ
alert	a l æ ʈ
alfabet	a l f a b eː t
alfågel	ɑː l f oː ɡ ɛ l
alförrädare	ɑː l f œ r ɛː d a r ɛ
alg	a l j
algerier	a l ɧ eː r ɪ ɛ r
algeriet	a l ɧ ɛ r iː ɛ t
algerisk	a l ɧ eː r ɪ s k
alkekung	a l k ɛ k ɵ ŋ
alkoholism	a l k ʊ h ʊ l ɪ s m
alkoholist	a l k ʊ h ʊ l ɪ s t
alla	a l a
allemansrätt	a l ɛ m a n s r ɛ t
allmän	a l m ɛ n
allmänbildning	a l m ɛ n b ɪ l d n ɪ ŋ
alltmer	a l t m eː r
alltså	a l t s ɔ
allvarlig	a l ʋ ɑː r l ɪ ɡ
allé	a l eː
alpseglare	a l p s eː ɡ l a r ɛ
altruism	a l t r ɵ ɪ s m
aluminium	a l ɵ m iː n ɪ ɵ m
amanda	a m a˧˩ n d a˥˩
ambitiös	a m b iː ɧ øː s
amerika	a m eː r ɪ k a
amma	a˧˩ m a˥˩
amper	a m p eː r
ampere	a m p æː r
amurfalk	ɑː m ɵ r f a l k
ana	ɑː˧˩ n a˥˩
and	a n d
anden	a n d ɛ n
andlig	a n d l ɪ ɡ
andra	a n d r a
andré	a n d r eː
anfalla	a n f a l a
ange	a n j eː
anka	a ŋ k a
ankeborg	a ŋ k ɛ b ɔ r j
anklagelse	a n k l ɑː ɡ ɛ l s ɛ
anna	a˧˩ n a˥˩
annons	a n ɔ n s
annons	a n ɔ ŋ s
anod	a n oː d
anod	a n uː d
anomali	a n ʊ m a l iː
ansat	a˧˩ n s a˥˩ t
ansatt	a˧˩ n s a˥˩ t
ansikte	a n s ɪ k t eː
antepenultima	a n t ɛ p ɛ n ɵ l t ɪ m a
antimon	a n t ɪ m oː n
antimon	a n t ɪ m uː n
antyda	a n t yː d a
apa	ɑː p a
apelsinjuice	a p ɛ l s iː˧˩ n j uː˥˩ s
apotek	a p ʊ t eː k
appellativ	a˧˩ p ɛ˥˩ l a t iː ʋ
april	a p r iː l
april	a p r ɪ l
arbetslös	a r b eː t s l øː s
arbus	ɑː r b ʉː s
arg	a r j
argon	a r ɡ oː n
argt	a r j t
arkimedes	a r k ɪ m eː d ɛ s
arkitekt	a r k ɪ t ɛ k t
arkitekt	a r ɕ ɪ t ɛ k t
arrangemang	a r a n ɧ eː m a ŋ
arrangera	a r a n ɧ eː r a
arsel	a r s ɛ l
arsenik	a r s ɛ n iː k
arton	ɑː˧˩ r t ɔ˥˩ n
arv	a r ʋ
aspig	a˧˩ s p ɪ˥˩ ɡ
asturisk	a s t ʉː r ɪ s k a
asturiska	a s t ʉː r ɪ s k a
att	a t
att	ɔ
attack	a t a k
aubergin	ɔ b ɛ r ɕ iː n
aubergin	ɔ b ɛ r ɕ ɪ n
aubergine	ɔ b ɛ r ɕ iː n
aubergine	ɔ b ɛ r ɕ ɪ n
augusti	a ʊ ɡ ɵ s t ɪ
aula	a ʊ l a
av	ɑː ʋ
avbrott	ɑː ʋ b r ɔ t
avfärda	ɑː ʋ f ɛ r d a
avi	a ʋ iː
avlat	ɑː ʋ l ɑː t
avlatskrämare	ɑː ʋ l ɑː t s k r ɛː m a r ɛ
avled	ɑː˧˩ ʋ l eː˥˩ d
avokado	a ʋ ʊ k ɑː d ʊ
avseende	ɑː ʋ s eː ɛ n d ɛ
avsiktlig	ɑː ʋ s iː k t l iː
avsked	ɑː ʋ ɧ eː d
avsky	ɑː ʋ ɧ yː
avskyvärd	ɑː ʋ ɧ ʏ ʋ ɛ r d
aw	ɑː ʋ eː
axel	a˥˧ k s ɛ˩ l
ba	b ɑː
babbe	b a b ɛ
babylift	b ɛ ɪ b ʏ l ɪ f t
backsvala	b a k s ʋ ɑː l a
bad	b ɑː d
bada	b ɑː˧˩ d a˥˩
badensisk	b a d ɛ n s ɪ s k
badstuga	b ɑː˧˩ d s t ʉː˥˩ ɡ a
bagage	b a ɡ ɑː ɧ
bajen	b a j ɛ n
bajs	b a j s
bajsa	b a˧˩ j s a˥˩
bak	b ɑː k
bakbord	b aː k b uː r d
balkansångare	b a l k a n s ɔ ŋ a r ɛ
ball	b a l
balle	b a l eː
bamba	b a m b a
bambamat	b a˧˩ m b a˥˩ m ɑː t
bambarast	b a˧˩ m b a˥˩ r a s t
bambatant	b a˧˩ m b a˥˩ t a n t
bana	b ɑː n a
banan	b a n ɑː n
banan	b ɑː n a n
bananskal	b a n ɑː n s k ɑː l
band	b a n d
bane	b ɑː˧˩ n ɛ˥˩
baneman	b ɑː˧˩ n ɛ˥˩ m a n
bank	b a ŋ k
bar	b ɑː r
barcelona	b a ʂ ɛ l oː˧˩ n a˥˩
barmhärtig	b a r m h ɛ ʈ ɪ ɡ
barn	b ɑː r n
barnbespisning	b ɑː˧˩ r n b ɛ˥˩ s p iː s n ɪ ŋ
barnet	b ɑː r n ɛ t
barnhem	b ɑː r n h ɛ m
barnmorska	b ɑː˧˩ r n m ʊ˥˩ r s k a
barriär	b a r ɪ æː r
barsk	b a ʂ k
bas	b ɑː s
basar	b a s ɑː r
basket	b ɑː s k ɛ t
bearbeta	b eː a r b eː t a
bebop	b iː b ɔ p
beckasin	b ɛ k a s iː n
beckasinsnäppa	b ɛ k a s iː n s n ɛ p a
bedrägeri	b ɛ d r ɛː ɡ ɛ r iː
begå	b ɛ ɡ oː
behov	b ɛ h uː ʋ
beige	b eː ɧ
beige	b ɛː ɧ
bekant	b ɛ k a n t
belgien	b ɛ l ɡ ɪ ɛ n
ben	b eː n
berg	b ɛ r j
bergand	b ɛ r j a n d
bergen	b ɛ r j ɛ n
bergens	b ɛ r j ɛ n s
berget	b ɛ r j ɛ t
bergets	b ɛ r j ɛ t s
bergs	b ɛ r j s
bergsångare	b ɛ r j s ɔ ŋ a r ɛ
bergtajgasångare	b ɛ r j t a j ɡ a s ɔ ŋ a r ɛ
bergtita	b ɛ r j t iː t a
berguv	b ɛ r j ʉː ʋ
berlin	b eː r l iː n
bert	b æ ʈ
beryllium	b ɛ r ʏ l ɪ ɵ m
besk	b ɛ s k
besked	b ɛ ɧ eː d
bespisa	b eː s p iː s a
bespisning	b ɛ s p iː s n ɪ ŋ
bestrida	b ɛ s t r iː d a
besvika	b ɛ s ʋ iː k a
beta	b ɛ t ɑː
betala	b ɛ t ɑː l a
bete	b eː t eː
beteende	b ɛ t eː ɛ n d ɛ
betyda	b ɛ t yː˥˧ d a˩
bikini	b ɪ k iː n ɪ
bil	b iː l
bilist	b ɪ l ɪ s t
biljard	b ɪ l j ɑː r d
biljon	b ɪ l j uː n
bill	b ɪ l
bilparkering	b iː l p a r k eː r ɪ ŋ
biologi	b ɪ ʊ l ʊ ɡ iː
birgitta	b ɪ r ɡ ɪ˧˩ t a˥˩
biskop	b iː s k ɔ p
bit	b iː t
bit	b ɪ t
bits	b iː t s
bits	b ɪ t s
bitvarg	b iː˧˩ t ʋ a˥˩ r j
biätare	b iː ɛ t a r ɛ
bjugg	b j ɵ ɡ
björn	b j øː r n
blad	b l ɑː˥˧ d
blandinaviska	b l a n d ɪ n ɑː ʋ ɪ s k a
blandning	b l a n d n iː ŋ
blankspola	b l a˧˩ ŋ k s p uː˥˩ l a
bleck	b l ɛ k
blev	b l eː ʋ
bli	b l iː
blida	b l iː d a
block	b l ɔ k
blod	b l uː d
blodröd	b l uː d r øː d
blodtörst	b l uː˧˩ d t œ˥˩ ʂ ʈ
blodtörst	b l uː˧˩ d t ɵ˥˩ ʂ ʈ
blodtörstig	b l uː˧˩ d t œ˥˩ ʂ ʈ ɪ ɡ
blodtörstig	b l uː˧˩ d t ɵ˥˩ ʂ ʈ ɪ ɡ
blogg	b l ɔ ɡ
blomma	b l ʊ m a
blomqvist	b l ʊ˧˩ m k ʋ ɪ˥˩ s t
blott	b l ɔ t
bly	b l yː
blyg	b l yː ɡ
bläck	b l ɛ k
bläs	b l ɛ s
bläsand	b l ɛ s a n d
bläsgås	b l ɛ s ɡ oː s
blå	b l oː
blåbär	b l oː b ɛː r
blåkråka	b l oː k r oː k a
blåljus	b l oː j ʉː s
blåljuscentral	b l oː˧˩ j ʉː˥˩ s s eː n t r ɑː l
blåljusfilter	b l oː j ʉː s f ɪ l t ɛ r
blåljusfordon	b l oː j ʉː s f uː r d uː n
blåljuspersonal	b l oː j ʉː s p ɛ ʂ ʊ n ɑː l
blåst	b l oː s t
blåst	b l ɔ s t
blåtand	b l oː˧˩ t a˥˩ n d
blått	b l ɔ t
boden	b uː d ɛ n
bodil	b uː˥˧ d ɪ˩ l
boel	b uː˥˧ ɛ˩ l
bog	b uː ɡ
bok	b uː k
boka	b uː k a
bokhandel	b uː˧˩ k h a˥˩ n d ɛ l
bokstav	b uː k s t ɑː ʋ
bokstav	b ʊ k s t ɑː ʋ
bolaget	b uː˧˩ l ɑː˥˩ ɡ ɛ t
bon	b uː n
bondska	b ʊ˧˩ n d s k a˥˩
boning	b uː n ɪ ŋ
bop	b ɔ p
bor	b oː r
bor	b uː r
bord	b uː ɖ
borde	b uː ɖ eː
bordsbön	b uː r d s b øː n
bordtennis	b uː˧˩ ɖ t ɛ˥˩ n ɪ s
boren	b uː r ɛ n
bortaplan	b ɔ˧˩ r t a˥˩ p l ɑː n
bortskänka	b ɔ˧˩ r t ɧ ɛ˥˩ ŋ k ɛ s
bot	b uː t
bot	b ɔ t
bota	b uː t a
botar	b uː t a r
bra	b r ɑː
braig	b r ɑː˧˩ ɪ˥˩ ɡ
brasklapp	b r a˧˩ s k l a˥˩ p
bre	b r eː
brev	b r eː ʋ
brevbärare	b r eː˧˩ ʋ b æː˥˩ r a r eː
brinna	b r ɪ˧˩ n a˥˩
bris	b r iː s
brista	b r ɪ s t a
bro	b r uː
bron	b r uː n
brons	b r uː n s
brons	b r ɔ n s
bronsibis	b r ɔ n s iː b ɪ s
bror	b r uː r
bros	b r uː s
broschyr	b r ʊ ɧ yː r
brun	b r ʉː˥˧ n
brunand	b r ʉː n a n d
bruno	b r ʉː n ʊ
brunsenap	b r ʉː n s eː n a p
brunsångare	b r ʉː n s ɔ ŋ a r ɛ
brushane	b r ʉː s h ɑː n ɛ
brygd	b r ʏ ɡ d
bryggd	b r ʏ ɡ d
brylling	b r ʏ˧˩ l ɪ˥˩ ŋ
bröd	b r øː d
bröt	b r øː t
bu	b ʉː
bud	b ʉː d
budgetpromenaden	b ɵ˧˩ d j ɛ˥˩ t p r ʊ m ɛ n ɑː d ɛ n
bulle	b ɵ˧˩ l ɛ˥˩
burdus	b ɵ r d ʉː s
buren	b ʉː˥˧ r ɛ˩ n
buren	b ʉː˧˩ r ɛ˥˩ n
bus	b ʉː s
busig	b ʉː s ɪ ɡ
busksångare	b ɵ s k s ɔ ŋ a r ɛ
buss	b ɵ s
bussarong	b ɵ s a r ɔ ŋ
busstation	b ɵ˧˩ s s t a˥˩ ɧ uː n
bygd	b ʏ ɡ d
bygga	b ʏ ɡ a
byling	b yː˧˩ l ɪ˥˩ ŋ
byrå	b yː r ɔ
byrå	b ʏ r oː
byte	b a j t
byte	b a ɪ t
byte	b yː t ɛ
byxis	b ʏ˥˧ k s ɪ˩ s
bäckna	b ɛ˧˩ k n a˥˩
bältdjur	b ɛ l t j ʉː r
bäng	b ɛ ŋ
bär	b ɛː r
bärs	b æ r s
bärs	b æː r s
bärsa	b æ˧˩ r s a˥˩
bävergäll	b ɛː ʋ ɛ r j ɛ l
båda	b oː d a
båge	b oː˧˩ ɡ ɛ˥˩
bål	b oː l
bår	b oː r
båt	b oː t
böcker	b ø˥˧ k ə˩ r
bödel	b øː d ɛ l
bög	b øː ɡ
bögig	b øː ɡ ɪ ɡ
böra	b œ r a
c	k
c	s
c	s eː
café	k a f eː
californium	k a l ɪ f oː r n ɪ ɵ m
calla	k oː l a
calle	k a˧˩ l ɛ˥˩
carina	k a r iː˧˩ n a˥˩
carl	k ɑː r l
carpmes	k a r p m eː s
centimeter	s ɛ n t ɪ m eː t ɛ r
centralort	s ɛ˧˩ n t r ɑː˥˩ l ʊ r t
cesium	s eː s ɪ ɵ m
cettisångare	s ɛ t ɪ s ɔ ŋ a r ɛ
champagne	ɧ a m p a n j
champinjon	ɧ a m p ɪ n j uː n
chans	ɕ a n s
chans	ɕ a ŋ s
chans	ɧ a n s
chans	ɧ a ŋ s
chark	ɧ a r k
charkuteri	ɧ a r k ɵ t ɛ r iː
charlie	ɕ ɑː ɭ ɪ
charlotta	ɧ a r ɭ o˧˩ t a˥˩
charlotte	ɧ a ɭ oː t
charm	ɧ a r m
charmör	ɧ a r m øː r
chaufför	ɧ a f œː r
chaufför	ɧ ɔ f œː r
check	ɕ ɛ k
cheddar	ɕ ɛ d a r
chef	ɧ eː f
chef	ɧ ɛː f
chips	ɕ ɪ p s
choklad	ɧ ʊ k l ɑː d
cineast	s ɪ n eː a s t
citron	s ɪ t r uː n
clown	k l a ʊ n
clownfisk	k l a ʊ n f ɪ s k
container	k ɔ n t ɛ j n ɛ r
cool	k uː l
cowboy	k a ʊ b ɔ j
croissant	k r ʊ a s a ŋ
cup	k a p
cup	k ɵ p
cyberattack	s yː b ɛ r a t a k
cykel	s yː k eː l
cykel	s ʏ k eː l
dadel	d a˥˧ d ɛ˩ l
dadel	d ɑː˥˧ d ɛ˩ l
dag	d ɑː ɡ
dags	d a k s
dags	d ɑː ɡ s
dam	d ɑː m
damm	d a m
dammsnäppa	d a m s n ɛ p a
dan	d ɑː n
danmark	d a˥˧ n m a˩ r k
dansk	d a n s k
danska	d a˧˩ n s k a˥˩
danskjävel	d a n s k j ɛː ʋ ɛ l
dativ	d ɑː t iː ʋ
dator	d ɑː˧˩ t ɔ˥˩ r
dator	d ɑː˧˩ t ʊ˥˩ r
de	d eː
de	d iː
de	d ɔ m
de	d ɪ
december	d ɛ s ɛ m b ɛ r
decennium	d ɛ s ɛ n ɪ ɵ m
decimeter	d ɛ s ɪ m eː t ɛ r
deg	d eː ɡ
dekameter	d ɛ k a m eː t ɛ r
dela	d eː l a
dem	d ɔ m
den	d ɛ n
denne	d ɛ n ɛ
design	d ɛ s a j n
designa	d ɪ s a j n a
dessa	d ɛ s a
dessutom	d eː s ʉː t ɔ m
det	d eː
det	d eː t
det	d ɛ t
det	d ɛː
det	r ɛ
det	ɛ t
detektiv	d ɛ t ɛ k t iː ʋ
detta	d ɛ t a
dig	d ɛ j
digitaliseringsminister	d ɪ ɡ ɪ t a l ɪ s eː r ɪ ŋ s m ɪ n ɪ s t ɛ r
dimmig	d ɪ m ɪ ɡ
ding	d ɪ ŋ
dirr	d ɪ r
diskrepans	d ɪ s k r ɛ p a n s
diskrepans	d ɪ s k r ɛ p a ŋ s
diskussion	d ɪ s k ɵ ɧ uː n
djungel	d j ʉː ŋ eː l
djungel	j ɵ ŋ ɛ l
djup	j ʉː p
djuphav	j ʉː p h ɑː ʋ
djupt	j ʉː p t
djur	j ʉː r
djärv	j ɛ r ʋ
djävla	j ɛː ʋ l a
dock	d ɔ k
dog	d uː ɡ
dogg	d ɔ ɡ
doktor	d ɔ k t ɔ r
dom	d oː m
dom	d ʊ m
dopparedagen	d ɔ˧˩ p a˥˩ r ɛ d ɑː n
dopparedagen	d ɔ˧˩ p a˥˩ r ɛ d ɑː ɡ ɛ n
dopping	d ɔ p ɪ ŋ
dos	d uː s
dra	d r ɑː
dragen	d r ɑː˥˧ ɡ ɛ˩ n
dragen	d r ɑː˧˩ ɡ ɛ˥˩ n
dragon	d r a ɡ uː n
dragspel	d r ɑː ɡ s p eː l
drake	d r ɑː k ɛ
dras	d r a s
dras	d r ɑː s
dressing	d r eː s iː ŋ
dricka	d r ɪ k a
dricker	d r ɪ k eː r
drillsnäppa	d r ɪ l s n ɛ p a
drog	d r oː ɡ
drog	d r uː ɡ
drogs	d r oː ɡ s
drogs	d r uː ɡ s
dromedar	d r ʊ m ɛ d ɑː r
droppen	d r ɔ p ɛ n
dränera	d r ɛ n eː˧˩ r a˥˩
dräng	d r ɛ ŋ
dröm	d r œ m
du	d ʉː
dubbel	d ɵ b ɛ l
dubbelbeckasin	d ɵ b ɛ l b ɛ k a s iː n
dubbelgångare	d ɵ b ɛ l ɡ ɔ ŋ a r ɛ
duk	d ʉː k
dum	d ɵ m
dumbom	d ɵ m b ʊ m
dumhuvud	d ɵ m h ɵ ʋ ɵ d
dun	d ʉː n
dusch	d ɵ ɕ
dusch	d ɵ ɧ
duscha	d ɵ˧˩ ɕ a˥˩
duscha	d ɵ˧˩ ɧ a˥˩
dussin	d ɵ˧˩ s ɪ˥˩ n
dvärg	d ʋ ɛ r j
dvärgbeckasin	d ʋ ɛ r j b ɛ k a s iː n
dvärgkanadagås	d ʋ ɛ r j k a n a d a ɡ oː s
dvärgmus	d ʋ ɛ r j m ʉː s
dvärgmås	d ʋ ɛ r j m oː s
dvärgskarv	d ʋ ɛ r j s k a r ʋ
dvärgspov	d ʋ ɛ r j s p uː ʋ
dvärgsumphöna	d ʋ ɛ r j s ɵ m p h øː n a
dvärgsångare	d ʋ ɛ r j s ɔ ŋ a r ɛ
dygna	d ʏ ŋ n a
dyr	d yː r
dysfori	d yː s f uː r iː
dysterkvist	d ʏ s t ɛ r k ʋ ɪ s t
däka	d ɛː˧˩ k a˥˩
där	d ɛː r
då	d oː
dålig	d oː l ɪ ɡ
död	d øː d
döda	d øː˧˩ d a˥˩
dölja	d œ l j a
dörr	d œ r
ed	eː d
edvin	eː d ʋ ɪ n
efor	eː f oː r
efter	ɛ f t ɛ r
egentlig	ɛ j ɛ n t l ɪ ɡ
egentlig	ɛ j ɛ ŋ k l ɪ ɡ
egentligen	ɛ j ɛ n t l ɪ ɡ ɛ n
egentligen	ɛ j ɛ ŋ k l ɪ ɡ ɛ n
egg	ɛ ɡ
egga	ɛ˧˩ ɡ a˥˩
egypten	ɛ j ʏ˥˧ p t ɛ˩ n
einsteinium	a j n s t a j n ɪ ɵ m
ek	eː k
ekmes	eː k m eː s
ekollon	eː˧˩ k ɔ˥˩ l ɔ n
eksångare	eː k s ɔ ŋ a r ɛ
el	eː l
elak	eː l a k
elak	eː l ɑː k
elcykel	eː l s ʏ k ɛ l
eld	ɛ l d
eldar	ɛ l d a r
eldslandet	ɛ l d s l a n d ɛ t
elefanta	ɛ l ɛ f a n t a
elegant	ɛ l ɛ ɡ a n t
elektron	ɛ l ɛ k t r oː n
eleonorafalk	ɛ l ɛ ɔ n oː r a f a l k
elfte	ɛ l f t ɛ
eller	ɛ l ɛ r
elva	ɛ l ʋ a
emigrant	ɛ m ɪ ɡ r a n t
emulera	ɛ m ɵ l eː r a
en	eː n
en	ɛ n
en	ɛ ŋ
enastående	eː˧˩ n a˥˩ s t oː ɛ n d ɛ
enda	ɛ n d a
energi	ɛ n ɛ r ɧ iː
enfaldig	eː n f a l d ɪ ɡ
engagemang	a ŋ ɡ a ɧ ɛ m a ŋ
engagera	a ŋ ɡ a ɧ eː r a
engelska	eː ŋ eː l s k a
england	ɛ ŋ l a n d
england	ɛ ŋ l ɑː n
england	ɛ ŋ l ɑː n d
enhetlig	eː n h eː t l ɪ ɡ
enkel	ɛ ŋ k ɛ l
enkelbeckasin	ɛ n k ɛ l b ɛ k a s iː n
ensam	ɛ n s a m
ensamhet	eː n s a m h eː t
ensamhet	ɛ n s a m h eː t
entrecôte	a n t r ɛ k oː
entrecôte	a n t r ɛ k oː t
entrecôte	a ŋ t r ɛ k oː
entrecôte	a ŋ t r ɛ k oː t
entré	a n t r eː
entré	a ŋ t r eː
entusiasm	a n t ɵ s ɪ a s m
entusiasm	a ŋ t ɵ s ɪ a s m
entusiasm	ɛ n t ɵ s ɪ a s m
er	eː r
era	eː r a
erbium	ɛ r b ɪ ɵ m
erinra	eː r ɪ n r a
erkänna	eː r ɕ ɛ n a
erkänt	eː r ɕ ɛ n t
erkänt	ɛː r ɕ ɛ n t
errata	eː r ɑː t a
errata	ɛ r ɑː t a
esperanto	ɛ s p ɛ r a n t ɔ
esperanto	ɛ s p ɛ r a n t ʊ
estniska	ɛ s t n ɪ s k a
ett	ɛ t
euro	j uː˥˧ r ʊ˩
euro	ɛ˥˧ ʋ r ʊ˩
europa	ɛ r uː p a
europium	ɛ r uː p ɪ ɵ m
europé	ɛ r ʊ p eː
eva	eː˧˩ ʋ a˥˩
evelina	ɛ ʋ ɛ l iː˧˩ n a˥˩
event	ɛ ʋ ɛ n t
experiment	ɛ k s p ɛ r ɪ m ɛ n t
fabrik	f a b r iː k
fackverk	f a k ʋ ɛ r k
fader	f ɑː d ɛ r
falang	f a l a ŋ
falla	f a l a
fallskärm	f a l ɧ ɛ r m
fan	f aː aː n
fan	f aː n
fan	f ɛː n
far	f ɑː r
fars	f ɑː r s
fartkamera	f ɑː ʈ k ɑː m ɛ r a
farväl	f a r ʋ ɛː l
farväl	f ɑː r ʋ ɛː l
fatabur	f ɑː˧˩ t a˥˩ b ʉː r
fattig	f a t ɪ ɡ
februari	f ɛ b r ɵ ɑː r ɪ
fejs	f ɛ j s
fem	f ɛ m
femtal	f ɛ m t ɑː l
femte	f ɛ m t ɛ
femtio	f ɛ˧˩ m t ɪ˥˩
femtio	f ɛ˧˩ m t ɪ˥˩ ʊ
femtiöring	f ɛ m t ɪ œː r ɪ ŋ
femton	f ɛ m t ɔ n
fena	f eː n a
fest	f ɛ s t
fet	f eː t
fett	f ɛ t
fia	f iː˧˩ a˥˩
ficka	f ɪ k a
fiende	f iː˧˩ ɛ˥˩ n d ɛ
fientlig	f ɪ ɛ n t l ɪ ɡ
figur	f ɪ ɡ ʉː r
fik	f iː k
fika	f iː˧˩ k a˥˩
fil	f iː l
filippa	f ɪ l ɪ˧˩ p a˥˩
filippintörnskata	f ɪ l ɪ p iː n t øː r n s k ɑː t a
filmatisera	f ɪ l m a t ɪ s eː r a
filmjölk	f iː l m j œ l k
filosofie	f ɪ l ɔ s ɔ f iː˧˩ ɛ˥˩
filosofie	f ɪ l ʊ s ʊ f iː˧˩ ɛ˥˩
filosofisk	f ɪ l ʊ s oː f ɪ s k
fimpa	f ɪ˧˩ m p a˥˩
fin	f iː n
final	f ɪ n ɑː l
finger	f ɪ ŋ ɛ r
fingers	f ɪ ŋ ɛ r s
finland	f iː n l ɑː n d
finland	f ɪ n l a n d
finna	f ɪ n a
finnjävel	f ɪ n j ɛː ʋ ɛ l
finska	f ɪ˧˩ n s k a˥˩
firre	f ɪ˧˩ r ɛ˥˩
fisk	f ɪ s k
fiske	f ɪ˧˩ s k ɛ˥˩
fisken	f ɪ s k ɛ n
fiskens	f ɪ s k ɛ n s
fisktärna	f ɪ s k t æː r n a
fission	f ɪ ɧ uː n
fitta	f ɪ t a
fittig	f ɪ t ɪ ɡ
fjantig	f j a˧˩ n t ɪ˥˩ ɡ
fjol	f j uː l
fjompig	f j ɔ m p ɪ ɡ
fjor	f j uː r
fjord	f j oː r d
fjord	f j uː r d
fjortis	f j oː ʈ ɪ s
fjortis	f j uː ʈ ɪ s
fjorton	f j uː ʈ ɔ n
fjorton	f j ʊ ʈ ɔ n
fjällabb	f j ɛ l l a b
fjällgås	f j ɛ l ɡ oː s
fjällpipare	f j ɛ l p iː p a r ɛ
fjällripa	f j ɛ l r iː p a
fjälluggla	f j ɛ l ɵ ɡ l a
fjärd	f j æː ɖ
fjärde	f j ɛː r d ɛ
fjäril	f j ɛː r ɪ l
fjärt	f j æ ʈ
flarra	f l a˧˩ r a˥˩
flata	f l ɑː t a
flicka	f l ɪ k a
flickan	f l ɪ k a n
flickor	f l ɪ k ʊ r
flod	f l uː d
flodvåg	f l uː d ʋ oː ɡ
flummig	f l ɵ m ɪ ɡ
fluor	f l oː r
flygskam	f l yː ɡ s k a m
flyktig	f l ʏ k t ɪ ɡ
flyta	f l yː˧˩ t a˥˩
flytta	f l ʏ t a
fläckdrillsnäppa	f l ɛ k d r ɪ l s n ɛ p a
flå	f l oː
flöte	f l øː˧˩ t ɛ˥˩
focka	f ɔ k a
folkmusik	f ɔ˧˩ l k m ɵ˥˩ s iː k
folköl	f ɔ˧˩ l k øː˥˩ l
fonetik	f ɔ n eː t iː k
formation	f ɔ r m a ɧ uː n
fors	f ɔ ʈ
forstmästare	f ɔ r s t m ɛ s t ɑː r eː
forstmästare	f ɔ˧˩ r s t m ɛ˥˩ s t a r ɛ
forstväsen	f ɔ r s t ʋ eː s eː n
forstväsen	f ɔ˧˩ r s t ʋ ɛː˥˩ s ɛ n
fort	f ɔ ʈ
fort	f ʊ ʈ
fosfor	f ɔ s f ɔ r
foster	f ʊ s t ɛ r
fosterland	f ʊ s t æ r l a n d
fot	f uː t
fotboll	f uː˧˩ t b ɔ˥˩ l
fotnot	f uː t n uː t
foula	f a ʊ l a
foxtrot	f ɔ k s t r ɔ t
frakt	f r a k t
fram	f r a m
framför	f r a˧˩ m f œː˥˩ r
fransk	f r a n s k
franska	f r a˧˩ n s k a˥˩
fred	f r eː d
fredag	f r eː d a
fredag	f r eː d ɑː ɡ
fredrika	f r eː d r iː˧˩ k a˥˩
fredrika	f r ɛ d r iː˧˩ k a˥˩
freestyle	f r iː s t a j l
fri	f r iː
friggebod	f r ɪ˧˩ ɡ ɛ˥˩ b uː d
frihet	f r iː h eː t
fritiof	f r ɪ˥˧ t ɕ ɔ˩ f
fritis	f r iː˥˧ t ɪ˩ s
fru	f r ʉː
frugge	f r ɵ˧˩ ɡ ɛ˥˩
frukt	f r ɵ k t
frunch	f r ɵ n ɧ
frys	f r yː s
främlingsfientlig	f r ɛ˧˩ m l ɪ˥˩ ŋ s f ɪ ɛ n t l ɪ ɡ
främlingsfientlighet	f r ɛ˧˩ m l ɪ˥˩ ŋ s f ɪ ɛ n t l ɪ ɡ h eː t
frände	f r ɛ n d ɛ
fråga	f r oː ɡ a
från	f r oː n
från	f r ɔ n
frånvaro	f r oː˧˩ n ʋ ɑː˥˩ r ʊ
frö	f r øː
fröjd	f r œ j d
fröken	f r øː k ɛ n
frös	f r øː s
fubbick	f ɵ b ɪ k
ful	f ʉː l
full	f ɵ l
fungera	f ɵ ŋ ɡ eː r a
funka	f ɵ ŋ k a
funktion	f ɵ ŋ k ɧ uː n
funktionell	f ɵ ŋ k ɧ ʊ n ɛ l
fur	f ʉː r
furnera	f ɵ r n eː r a
fusion	f ɵ ɧ uː n
fusk	f ɵ s k
futurum	f ɵ t ʉː r ɵ m
fy	f yː
fyr	f yː r
fyra	f yː r a
fyrmänning	f yː˧˩ r m ɛ˥˩ n ɪ ŋ
fyrtal	f yː r t ɑː l
fyrtio	f œ˧˩ r t ɪ˥˩
fyrtio	f œ˧˩ r t ɪ˥˩ ʊ
fä	f ɛː
fälad	f ɛː˧˩ l a˥˩ d
fälad	f ɛː˧˩ l ɑː˥˩ d
fältsångare	f ɛ l t s ɔ ŋ a r ɛ
fän	f ɛː n
fänkål	f ɛː n k oː l
fänrik	f ɛ n r ɪ k
färg	f ɛ r j
färsk	f ɛ r s k
färskvatten	f ɛ r s k ʋ a t ɛ n
fäst	f ɛ s t
få	f oː
fågel	f oː ɡ ɛ l
fårakläder	f oː˧˩ r a˥˩ k l ɛː d ɛ r
fåtölj	f ɔ t œ l j
fåtölj	f ʊ t œ l j
föda	f øː d a
födelsedag	f øː d ɛ l s ɛ d ɑː ɡ
födelsedag	f øː l s ɛ d ɑː ɡ
fönster	f œ n s t ɛ r
fönstertittarsjuka	f œ˧˩ n s t ɛ˥˩ r t ɪ t a r ɧ ʉː k a
för	f øː r
förbruka	f œ r b r ʉː k a
förbud	f œ r b ʉː d
förbundskapten	f œ r b ɵ˧˩ n d s k a˥˩ p t eː n
förbutik	f øː r b ʉː t iː k
fördriva	f œ r ɖ r iː ʋ a
fördöma	f ɵ r d ɵ m a
före	f øː˧˩ r ɛ˥˩
förebrå	f øː r ɛ b r oː
föregångare	f øː r ɛ ɡ ɔ ŋ a r ɛ
förena	f œ r eː n a
förening	f œ r eː n ɪ ŋ
förete	f øː r ɛ t eː
förgänglig	f œ r j ɛ ŋ l ɪ ɡ
förgäves	f œ r j ɛː ʋ ɛ s
förnuftig	f œ ɳ ɵ f t iː ɡ
förr	f œ r
förrän	f œ r ɛ n
försiktighet	f øː r s ɪ k t ɪ ɡ h eː t
förskolelärare	f øː r s k uː l ɛ l ɛː r a r ɛ
förskollärare	f øː r s k uː l ɛ l ɛː r a r ɛ
förskräcklig	f œ r s k r ɛ k l ɪ ɡ
först	f œ ʂ ʈ
första	f œ ʂ ʈ a
förstå	f œ r s t oː
förstås	f ɶ ʂ t oː s
förstås	f ɶ ʂ t ɔ s
förstöra	f œ ʂ ʈ œː r a
försvarare	f øː r s ʋ ɑː r a r ɛ
försvarstal	f œ r s ʋ ɑː˧˩ r s t ɑː˥˩ l
försöka	f œ r s øː k a
förträfflig	f œ r ʈ r ɛ f l ɪ ɡ
förut	f øː r ʉː t
förut	f œ r ʉː t
förvirring	f øː r ʋ ɪ r ɪ ŋ
förvärra	f œ r ʋ æ r a
förvärras	f œ r ʋ æ r a s
förälder	f œ r ɛ˥˧ l d æ˩ r
förälskelse	f œ r ɛ l s k ɛ l s ɛ
g	j
g	ɡ
g	ɡ eː
g	ɧ
gabbe	ɡ a˧˩ b ɛ˥˩
gabriel	ɡ ɑː b r ɪ ɛ l
galax	ɡ a l a k s
galär	ɡ a l ɛ r
gamme	ɡ a˧˩ m ɛ˥˩
gammeldans	ɡ a˧˩ m ɛ˥˩ l d a n s
gammelgädda	ɡ a˧˩ m ɛ˥˩ l j ɛ d a
gammelmedia	ɡ a˧˩ m ɛ˥˩ l m eː d ɪ a
garage	ɡ a r ɑː ɕ
garage	ɡ a r ɑː ɧ
garanti	ɡ a r a n t ɪ
gas	ɡ ɑː s
gata	ɡ ɑː t a
gav	ɡ ɑː ʋ
ge	j eː
gelé	ɧ ɛ l eː
gem	j eː m
gem	ɡ eː m
gen	j eː n
general	j ɛ n ɛ r ɑː l
generös	ɧ ɛ n ɛ r øː s
genitiv	j eː n ɪ t iː ʋ
genom	j eː n oː m
genom	j eː n ɔ m
genre	ɧ a˥˧ ŋ ɛ˩ r
genren	ɧ a ŋ ɛ r n
genrer	ɧ a ŋ r a r
genrerna	ɧ a ŋ r a r n a
gentil	ɧ a ŋ t iː l
georg	j eː ɔ r j
ger	j eː r
germanium	j ɛ r m ɑː n ɪ ɵ m
gert	j æ ʈ
gert	ɡ æ ʈ
gest	ɧ ɛ s t
get	j eː t
geting	j eː t ɪ ŋ
getruta	j eː t r ʉː t a
gevär	j ɛ ʋ ɛː r
gick	j ɪ k
gifter	j ɪ˥˧ f t ɛ˩ r
gifter	j ɪ˧˩ f t ɛ˥˩ r
giftig	j ɪ f t ɪ ɡ
gin	dʒ ɪ n
gin	j ɪ n
gipsplatta	j ɪ p s p l a t a
gipsskiva	j ɪ p s ɧ iː ʋ a
gir	j iː r
giraff	ɧ ɪ r a f
gita	j iː˧˩ t a˥˩
gitarr	j ɪ t a r
gitta	j ɪ˧˩ t a˥˩
gitta	ɡ ɪ˧˩ t a˥˩
gjord	j uː r d
gjord	j ʊ ɖ
gjorde	j ʊ ɖ ɛ
gjort	j ʊ ʈ
gjuta	j ʉː˧˩ t a˥˩
glad	ɡ l ɑː d
gladlynt	ɡ l ɑː d l yː n t
gladlynt	ɡ l ɑː d l ʏ n t
glas	ɡ l ɑː s
glashus	ɡ l ɑː˧˩ s h ʉː˥˩ s
glasmästarsill	ɡ l ɑː˧˩ s m ɛ˥˩ s t a r s ɪ l
glass	ɡ l a s
glassmaskin	ɡ l a s m a ɧ iː n
glatt	ɡ l a t
gluttsnäppa	ɡ l ɵ t s n ɛ p a
glögg	ɡ l œ ɡ
gnag	ɡ n ɑː ɡ
god	ɡ uː
god	ɡ uː d
goddag	ɡ ʊ d ɑː ɡ
golv	ɡ ɔ l ʋ
gott	ɡ ɔ t
gradu	ɡ r ɑː d ʉː
gran	ɡ r ɑː n
gransångare	ɡ r ɑː n s ɔ ŋ a r ɛ
grattis	ɡ r a˥˧ t ɪ˩ s
gratäng	ɡ r a t ɛ ŋ
gravand	ɡ r ɑː ʋ a n d
gravitation	ɡ r a ʋ ɪ t a ɧ uː n
gravlax	ɡ r ɑː ʋ l a k s
green	ɡ r iː n
grej	ɡ r ɛ j
grekland	ɡ r eː k l a n d
grep	ɡ r eː p
grina	ɡ r iː n a
grip	ɡ r iː p
groda	ɡ r uː d a
gross	ɡ r ɔ s
grov	ɡ r uː ʋ
grund	ɡ r ɵ n d
grym	ɡ r ʏ m
grymta	ɡ r ʏ m t a
gryning	ɡ r yː n ɪ ŋ
gryta	ɡ r yː t a
gräddbulle	ɡ r ɛ˧˩ d b ɵ˥˩ l ɛ
gräddfil	ɡ r ɛ d f iː l
gräsand	ɡ r ɛː s a n d a n d
grät	ɡ r ɛː t
gråben	ɡ r oː˧˩ b eː˥˩ n
grågam	ɡ r oː ɡ ɑː m
grågås	ɡ r oː ɡ oː s
gråhakedopping	ɡ r oː h ɑː k ɛ d ɔ p ɪ ŋ
gråhäger	ɡ r oː h ɛ ɡ ɛ r
gråspett	ɡ r oː s p ɛ t
gråsäl	ɡ r oː s ɛː l
gråt	ɡ r oː t
gråtrut	ɡ r oː t r ʉː t
grön	ɡ r øː n
grönbena	ɡ r øː n b eː n a
grönkål	ɡ r øː n k oː l
grönsångare	ɡ r øː n s ɔ ŋ a r ɛ
gröt	ɡ r øː t
gubbe	ɡ ɵ b ɛ
gud	ɡ ʉː d
guding	ɡ ʉː d ɪ ŋ
guds	ɡ ɵ t s
gul	ɡ ʉː l
gula	ɡ ʉː˧˩ l a˥˩
guld	ɡ ɵ l d
gullgosse	ɡ ɵ˧˩ l ɡ ɔ˥˩ s ɛ
gullviva	ɡ ɵ l ʋ iː ʋ a
gump	ɡ ɵ m p
gungfly	ɡ ɵ˧˩ ŋ f l yː˥˩
gurra	ɡ ɵ˧˩ r a˥˩
guru	ɡ ʉː r ɵ
guss	ɡ ɵ s
guss	ɡ ɵ z
gym	j ʏ m
gymma	j ʏ˧˩ m a˥˩
gymnasium	dʒ ʏ m n ɑː s ɪ ɵ m
gymnasium	j ʏ m n ɑː s ɪ ɛ
gyros	j yː r ʊ s
gyros	ɡ yː r ʊ s
gäri	ɡ ɛː r ɪ
gärna	j ɛː ɳ a
gäst	j ɛ s t
gästfrihet	j ɛ s t f r iː h eː t
gästgiveri	j æ s t j iː ʋ ɛ r iː
gästgiveri	j æ s t j ɪ ʋ ɛ r iː
gästgiveri	j æ ɧ ɪ ʋ ɛ r iː
gävle	j ɛː ʋ l ɛ
gå	ɡ oː
gång	ɡ ɔ ŋ
gången	ɡ ɔ ŋ eː n
gångjärn	ɡ ɔ ŋ j ɛː r n
gård	ɡ oː r d
gås	ɡ oː s
gåskarl	ɡ oː s k ɑː r
gåstol	ɡ oː s t uː l
gått	ɡ ɔ t
gök	j øː k
göktyta	j øː k t yː t a
göl	j øː l
gör	ɡ øː r
göra	j øː˧˩ r a˥˩
göra	ɡ œː˧˩ r a˥˩
göran	j øː r a n
gördel	j œ r d ɛ l
göt	ɡ øː t
göteborg	j œ t ɛ b ɔ r j
göteborgska	j œ t eː b ɔ˧˩ r j s k a˥˩
gött	j œ t
gött	ɡ œ t
ha	h a
ha	h ɑː
ha	h ɑː ʋ a
hade	h a˧˩ d ɛ˥˩
haft	h a f t
hage	h ɑː ɡ ɛ
hagtorn	h a k t uː r n
hagtorn	h ɑː˧˩ ɡ t uː˥˩ r n
haj	h a j
hall	h a l
hallon	h a l ɔ n
hallå	h a l oː
halmbock	h a˧˩ l m b ɔ˥˩ k
halv	h a l ʋ
halvlek	h a˧˩ l ʋ l eː˥˩ k
hambo	h a m b ʊ
han	h a n
hand	h a n d
handikapp	h a n d ɪ k a p
handikapp	h a˧˩ n d i˥˩ k a p
handskrift	h a n d s k r ɪ f t
handtryck	h a˧˩ n d t r ʏ˥˩ k
hantverk	h a n t ʋ ɛ r k
har	h ɑː r
hara	h ɑː r a
hat	h ɑː t
hatt	h a t
hav	h ɑː ʋ
havre	h ɑː˧˩ ʋ r ɛ˥˩
havssula	h a ʋ s ʉː l a
havstrut	h a ʋ s t r ʉː t
havsörn	h a ʋ s øː r n
heat	h iː t
hej	h ɛ j
hekto	h ɛ k t ʊ
hel	h eː l
helg	h ɛ l j
helga	h ɛ l ɡ a
helig	h eː l ɪ ɡ
helium	h eː l ɪ ɵ m
helsingborg	h ɛ l s ɪ ŋ b ɔ r j
helsingfors	h ɛ l s ɪ ŋ f ɔ r s
helsingfors	h ɛ l s ɪ ŋ f ɔ ʈ
helsingör	h ɛ l s ɪ ŋ øː r
helvete	h ɛ l ʋ eː t ɛ
helvete	h ɛ l ʋ ɛ t ɛ
hem	h ɛ m
hembränd	h ɛ˧˩ m b r ɛ˥˩ n d
hembränt	h ɛ˧˩ m b r ɛ˥˩ n t
hemester	h ɛ m ɛ s t ɛ r
hemläxa	h ɛ˧˩ m l ɛ˥˩ k s a
hemmaplan	h ɛ˧˩ m a˥˩ p l ɑː n
hemul	h eː m ʉː l
hen	h eː n
hen	h ɛ n
henne	h ɛ n ɛ
henom	h ɛ n ɔ m
hens	h ɛ n s
herbert	h æ˥˧ r b æ˩ ʈ
herdestund	h eː˧˩ r d ɛ˥˩ s t ɵ n d
herr	h ɛ r
herre	h ɛ˧˩ r ɛ˧˩
hertz	h æ r t s
heta	h eː t a
hetvägg	h eː t ʋ ɛ ɡ
hia	h iː˧˩ a˥˩
hialös	h iː˧˩ a˥˩ l øː s
himalayagyllenmes	h iː m ɑː l ɪ j a j ʏ l ɛ n m eː s
hinsidan	h iː˧˩ n s iː˥˩ d a n
hinsidan	h ɪ˧˩ n s iː˥˩ d a n
hispa	h ɪ˧˩ s p a˥˩
hispig	h ɪ˧˩ s p ɪ˥˩ ɡ
hitta	h ɪ t a
hjord	j uː ɖ
hjort	j ʊ r t
hjorta	j ʊ r t a
hjortron	j ʊ ʈ r ɔ n
hjul	j ʉː l
hjälm	j ɛ l m
hjälp	j ɛ l p
hjälpa	j ɛ l p a
hjälte	j ɛ l t ɛ
hjärna	j ɛː ɳ a
hjärta	j ɛ r t a
hjärtinfarkt	j ɛ˧˩ r t ɪ˥˩ n f a r k t
hjärtlig	j æ˧˩ ʈ l ɪ˥˩ ɡ
hockeyfrilla	h ɔ k ɪ f r ɪ l a
hockeyfrilla	h ɔ k ʏ f r ɪ l a
holm	h ɔ l m ɛ
homofili	h uː m uː f iː l iː
homosex	h uː m ʊ s eː k s
hon	h ʊ n
honom	h ɔ n ɔ m
honung	h oː n ɵ ŋ
hoppa	h ɔ p a
hoppeligen	h ɔ p eː l iː ɡ eː n
hoppeligen	h ɔ˧˩ p ɛ˥˩ l iː ɡ ɛ n
hor	h uː r
hornuggla	h ʊ r n ɵ ɡ l a
horoskop	h ʊ r ʊ s k oː p
hos	h uː s
hot	h uː t
hotell	h ʊ t ɛ l
hov	h oː ʋ
hov	h uː ʋ
hud	h ʉː d
hudsonspov	h ɑː d s ɔ n s p uː ʋ
huggmejsel	h ʊ ɡ m ɛ j s ɛ l
humle	h ɵ m l ɛ
hund	h ɵ n d
hundra	h ɵ n d r a
hungrig	h ɵ ŋ r ɪ ɡ
hur	h ʉː r
hurring	h ɵ˧˩ r ɪ˥˩ ŋ
hus	h ʉː s
husdjur	h ʉː s j ʉː r
husmanskost	h ʉː˧˩ s m a˥˩ n s k ɔ s t
hussvala	h ʉː s s ʋ ɑː l a
hustru	h ɵ˧˩ s t r ʉː˧˩
huv	h ʉː ʋ
huvud	h ʉː ʋ ɵ d
hyf	h yː f
hygglig	h ʏ ɡ l ɪ ɡ
hylla	h ʏ l a
hyperdrift	h yː˧˩ p ɛ˥˩ r d r ɪ f t
hyrkanmes	h ʏ r k a n m eː s
häftig	h ɛ f t ɪ ɡ
hägna	h ɛ ŋ n a
häl	h ɛː l
häll	h ɛ l
hällregn	h ɛ l r ɛ ŋ n
här	h æː r
häradshövding	h æː r a d s h œ ʋ d ɪ ŋ
häradsrätt	h æː r a d s r ɛ t
härför	h æː r f øː r
härk	h ɛ r k
härlig	h æː ɭ ɪ ɡ
härmsångare	h ɛ r m s ɔ ŋ a r ɛ
härold	h ɛː˧˩ r ɔ˥˩ l d
håg	h oː ɡ
håla	h oː l a
håna	h oː n a
hår	h oː r
hårdrockare	h oː r d r oː k a r ɛ
hårt	h oː ʈ
håv	h oː ʋ
höbal	h øː b ɑː l
hög	h øː ɡ
höga	h øː ɡ a
högkvarter	h øː ɡ k ʋ a r t eː r
högljudd	h øː˧˩ ɡ j ɵ˥˩ d
högljutt	h øː˧˩ ɡ j ɵ˥˩ t
högsvenska	h øː ɡ s ʋ eː n s k ɑː
högsvenska	h øː˧˩ ɡ s ʋ ɛ˥˩ n s k a
högtid	h øː ɡ t iː d
högtid	h œ k t iː d
hök	h øː k
hölja	h œ l j a
höna	h øː˧˩ n a˥˩
höst	h œ s t
höstas	h œ˧˩ s t a˥˩ s
höstdagjämning	h œ s t d ɑː ɡ j ɛ m n ɪ ŋ
i	iː
i	ɪ
idissla	iː˧˩ d ɪ˥˩ s l a
idrott	iː˧˩ d r ɔ˥˩ t
igelkott	iː ɡ ɛ l k ɔ t
igenom	ɪ j eː n ɔ m
ignorera	ɪ ŋ n ʊ r eː r a
ihjäl	ɪ j ɛː l
ikea	ɪ k eː˧˩ a
illamående	ɪ l a m oː ɛ n d ɛ
illusion	ɪ l ɵ ɧ uː n
imperfekt	ɪ m p ɛ r f ɛ k t
in	ɪ n
inandning	ɪ˧˩ n a˥˩ n d n ɪ ŋ
inbjudan	ɪ˧˩ n b j ʉː˥˩ d a n
indian	ɪ n d ɪ ɑː n
infinitiv	ɪ n f ɪ n ɪ t iː ʋ
inga	ɪ˧˩ ŋ a˥˩
ingendera	ɪ˧˩ ŋ ɛ˥˩ n d eː r a
ingenjör	ɪ n ɧ ɛ n j øː r
ingenting	ɪ ŋ ɛ n tʰ ɪ ŋ
inger	ɪ˧˩ n j eː˥˩ r
inkapabel	ɪ n k a p ɑː b ɛ l
inn	ɪ n
innan	ɪ˧˩ n a˥˩ n
innanför	ɪ˧˩ n a˥˩ n f øː r
insexnyckel	ɪ n s ɛ k s n ʏ k ɛ l
insjukna	ɪ˧˩ n ɧ ʉː˥˩ k n a
inspektion	ɪ n s p ɛ k ɧ uː n
instruktion	ɪ n s t r ɵ k ɧ uː n
inte	ɪ˧˩ n t ɛ˥˩
integral	ɪ n t ɛ ɡ r aː l
internationell	ɪ n t ɛ r n a t ɧ ʊ n ɛ l
internet	ɪ n t ɛ r n ɛ t
intervju	ɪ n t ɛ r ʋ j ʉː
intryck	ɪ n t r ʏ k
iriomotemes	ɪ r ɪ j ɔ m ɔ t ɛ m eː s
irland	ɪ r l a n d
irra	ɪ r a
isabella	ɪ s a b ɛ˧˩ l a˥˩
isabellatörnskata	ɪ s a b ɛ l a t øː r n s k ɑː t a
ismås	iː s m oː s
israel	ɪ s r a eː l
italien	ɪ t ɑː l ɪ ɛ n
ivar	iː ʋ a r
j	j
j	j iː
j	ɧ
ja	j a
ja	j aː
ja	j ɑː
jacka	j a k a
jacke	j a˧˩ k ɛ˥˩
jag	j ɑː ɡ
jaga	j ɑː ɡ a
jak	j ɑː k
jaktfalk	j a k t f a l k
jalla	j a l l a
jalusi	ɧ a l ɵ s iː
januari	j a n ɵ ɑː r ɪ
japan	j a p ɑː n
japan	j ɑː˥˧ p a˩ n
japanare	j a p ɑː˧˩ n a˥˩ r ɛ
japansk	j a p ɑː n s k
japanska	j a p ɑː n s k a
jargong	ɧ a r ɡ ɔ ŋ
jasmine	ɧ a s m iː n
jennie	j ɛ˥˧ n ɪ˩
jenny	j ɛ˥˧ n ʏ˩
jerusalem	j ɛ r ʉː˧˩ s a˥˩ l ɛ m
jesuit	j ɛ s ʉː iː t
jesus	j eː s ɵ s
jesus	j eː˧˩ s ɵ˥˩ s
jiddra	j ɪ˧˩ d r a˥˩
jo	j uː
jocke	j ʊ˧˩ k ɛ˥˩
jod	j ɔ d
johan	j ʊ a n
johanna	j ʊ h a˧˩ n a˥˩
joint	dʒ ɔ ɪ n t
joint	j ɔ ɪ n t
jojk	j ɔ j k
jojka	j ɔ˧˩ j k a˥˩
jojo	j ʊ j ʊ
jokk	j ɔ k
jolle	j ɔ l eː
jonas	j uː n a s
jonsson	j ʊ n s ɔ n
jonte	j ɔ˧˩ n t ɛ˥˩
joppe	j ɔ p eː
jord	j uː ɖ
jorden	j uː r d ɛ n
jordgubbe	j uː ɖ ɡ ɵ b ɛ
jorduggla	j ʊ r d ɵ ɡ l a
jordvarg	j uː ɖ ʋ a r j
jota	j uː˧˩ t a˥˩
journal	ɧ ʊ ɳ ɑː l
journalist	ɧ ʊ r n a l ɪ s t
jox	j ʊ k s
ju	j ɵ
ju	j ʉː
judetyska	j ʉː˧˩ d ɛ˥˩ t ʏ s k a
juice	j uː s
jul	j ʉː l
julas	j ʉː˧˩ l a˥˩ s
julgranskula	j ʉː˧˩ l ɡ r ɑː˥˩ n s k ʉː l a
juli	j ʉː l ɪ
julmust	j ʉː˧˩ l m ɵ˥˩ s t
jungfrukälla	j ʉː ŋ f r ʉː ɕ ɛ l a
jungfrutrana	j ɵ ŋ f r ɵ t r ɑː n a
juni	j ʉː n ɪ
jupiter	j ʉː p ɪ t ɛ r
jury	j ɵ r ʏ
juver	j ʉː ʋ ɛ r
jägmästare	j ɛː˧˩ ɡ m ɛ˥˩ s t a r ɛ
järn	j ɛː r n
järpe	j ɛ r p ɛ
järv	j æ r ʋ
jäst	j ɛ s t
jävel	j ɛː ʋ ɛ l
jävig	j ɛː ʋ ɪ ɡ
jönköping	j œ n ɕ øː p ɪ ŋ
k	k
k	k oː
k	ɕ
kadmium	k a d m ɪ ɵ m
kaffe	kʰ a˧˩ f ɛ˥˩
kaffegök	kʰ a f eː j øː k
kaffepumla	k a˧˩ f ɛ˥˩ p ɵ m l a
kafé	k a f eː
kajak	k a j ɑː k
kal	k ɑː l
kalabalik	k a l a b a l iː k
kalcium	k a l s ɪ ɵ m
kalifornien	k a l ɪ f uː r n ɪ ɛ n
kalium	k ɑː l ɪ ɵ m
kalk	k a l k
kalkon	k a l k uː n
kall	k a l
kalla	k a l a
kalle	k a˧˩ l ɛ˥˩
kalmarit	k a l m a r iː t
kam	k a m
kamera	k ɑː m ɛ r a
kan	k a n
kanadagås	k a n a d a ɡ oː s
kanadames	k a n a d a m eː s
kanadensisk	k a n a d ɛ n s ɪ s k
kanelbulle	k a n eː l b ɵ l ɛ
kanelsnäcka	k a n eː l s n ɛ k a
kanske	k a˧˩ n ɧ ɛ˥˩
kaos	k a ʊ s
kaos	k ɑː ʊ s
kapmes	k ɑː p m eː s
kappa	k a p a
kar	k ɑː r
karbin	k a r b iː n
kardinal	k a ɖ ɪ n ɑː l
karina	k a r iː˧˩ n a˥˩
karl	k ɑː r
karl	k ɑː r l
karolina	k a r ʊ l iː˧˩ n a˥˩
karolinasumphöna	k a r ʊ l iː n a s ɵ m p h øː n a
karolinatita	k a r ʊ l iː n a t iː t a
karta	k ɑː r t a
kasse	k a˧˩ s ɛ˥˩
kasus	k ɑː s ɵ s
katarina	k a t a r iː˧˩ n a˥˩
katod	k a t oː d
katod	k a t uː d
katrina	k a t r iː˧˩ n a˥˩
katt	k a t
kebabdjur	k ɛ b a b j ʉː r
kedja	ɕ eː˧˩ d j a˥˩
kedja	ɕ ɛː˧˩ d j a˥˩
keff	k ɛ f
kejsarörn	ɕ ɛ j s a r øː r n
kemi	ɕ ɛ m iː
keramik	ɕ ɛ r a m iː k
kerstin	ɕ æ˧˩ ʂ t ɪ˥˩ n
ketchup	k ɛ t ɕ ɵ p
kex	k ɛ k s
kex	ɕ ɛ k s
kidnappa	k iː˧˩ d n a˥˩ p a
kika	ɕ iː k a
kil	ɕ iː l
kille	k ɪ˧˩ l ɛ˥˩
kille	ɕ ɪ˧˩ l ɛ˥˩
kilo	k iː l ʊ
kilo	ɕ iː l ʊ
kilometer	ɕ ɪ l ʊ m eː t ɛ r
kina	ɕ iː˧˩ n a˥˩
kind	ɕ ɪ n d
kinders	ɕ ɪ n d ɛ r s
kines	ɕ ɪ n eː s
kinesa	ɕ ɪ n eː s a
kinesisk	ɕ ɪ n eː s ɪ s k
kinesiska	ɕ ɪ n eː s ɪ s k a
kiosk	k j ɔ s k
kiosk	k ɪ ɔ s k
kiosk	ɕ ɔ s k
kioskmongo	ɕ ɔ s k m ɔ ŋ ɡ ʊ
kioskvältare	ɕ oː s k ʋ ɛ l t a r ɛ
kirra	k ɪ˧˩ r a˥˩
kirurg	ɕ ɪ r ɵ r ɡ
kis	k iː s
kis	ɕ iː s
kisel	ɕ iː s ɛ l
kiss	k ɪ s
kissa	k ɪ s a
kista	ɕ ɪ s t a
kitsch	k ɪ t ɧ
kitschig	k ɪ t ɧ ɪ ɡ
kittel	ɕ ɪ t ɛ l
kjell	ɕ ɛ l
kjellberg	ɕ ɛ l b æ r j
kjol	ɕ uː l
kladdkaka	k l a˧˩ d k ɑː˥˩ k a
klandra	k l a n d r a
klar	k l ɑː r
klinga	k l ɪ˧˩ ŋ a˥˩
klingonska	k l ɪ ŋ ɔ n s k a
klintbergare	k l iː n t b ɛː r j a r eː
klippduva	k l ɪ p d ʉː ʋ a
klippkaja	k l ɪ p k a j a
klippsvala	k l ɪ p s ʋ ɑː l a
klittra	k l ɪ t r a
klocka	k l ɔ k a
klonken	k l ɔ ŋ k ɛ n
klor	k l oː r
klor	k l uː r
kläde	k l ɛː d ɛ
kläder	k l ɛː d ɛ r
klädhängare	k l ɛ d h ɛ ŋ a r ɛ
klå	k l oː
klår	k l oː r
klökas	k l øː˧˩ k a˥˩ s
klövdjur	k l øː ʋ j ʉː r
knapp	k n a p
knappologi	k n a p ʊ l ʊ ɡ iː
knark	k n a r k
knarka	k n a r k a
knoparmoj	k n uː˧˩ p a˥˩ r m ɔ j
knubbsäl	k n ɵ b s ɛː l
knulla	k n ɵ l a
knut	k n ʉː t
knuten	k n ʉː˥˧ t ɛ˩ n
knuten	k n ʉː˧˩ t ɛ˥˩ n
knåda	k n oː˧˩ d a˥˩
knô	k n œː
knö	k n œː
knöl	k n øː l
knölsvan	k n ø l s ʋ ɑː n
knölsvärta	k n ø l s ʋ ɛ ʈ a
ko	k uː
kobolt	k oː b ɔ l t
kobolt	k uː b ɔ l t
koboltmes	k uː b ɔ l t m eː s
kod	k uː d
kofta	k ɔ f t a
kol	k oː l
kolla	k ɔ l a
kolymasnäppa	k ɔ l yː m a s n ɛ p a
kom	k ɔ m
komma	k ɔ˧˩ m a˥˩
kommer	k ɔ m ɛ r
kompis	k ɔ˥˧ m p ɪ˩ s
komplett	k ɔ m p l ɛ t
kon	k uː n
kondition	k ɔ n d ɪ ɧ uː n
konflikt	k ɔ n f l ɪ k t
konspiration	k ɔ n s p ɪ r a ɧ uː n
konspirationsteoretiker	k ɔ n s p ɪ r a ɧ uː˧˩ n s t ɛ˥˩ ʊ r eː t ɪ k ɛ r
konspirationsteori	k ɔ n s p ɪ r a ɧ uː˧˩ n s t ɛ˥˩ ʊ r iː
konst	k ɔ n s t
konstbefrukta	k ɔ˧˩ n s t b ɛ˥˩ f r ɵ k t a
konstbevattna	k ɔ˧˩ n s t b ɛ˥˩ ʋ a t n a
konstbevattning	k ɔ˧˩ n s t b ɛ˥˩ ʋ a t n ɪ ŋ
konstfiber	k ɔ˧˩ n s t f iː˥˩ b ɛ r
konstgjord	k ɔ˧˩ n s t j uː˥˩ r d
konstgjord	k ɔ˧˩ n s t j ʊ˥˩ r d
konstläder	k ɔ˧˩ n s t l ɛː˥˩ d ɛ r
konstruktion	k ɔ n s t r ɵ k ɧ uː n
konsumtion	k ɔ n s ɵ m ɧ uː n
kontra	k ɔ n t r a
kontrast	k ʊ n t r a s t
konung	k oː n ɵ ŋ
konungarike	k oː n ɵ ŋ a r iː k ɛ
kopia	k ʊ p iː˧˩ a˥˩
koppar	k ɔ p a r
kopparand	k ɔ p a r a n d
koppling	k ɔ p l ɪ ŋ
kopplingskåpa	k ɔ˧˩ p l ɪ˥˩ ŋ s k oː p a
kor	k uː r
korea	k ʊ r eː˧˩ a˥˩
korean	k ʊ r eː aː n
korg	k ɔ r j
kornknarr	k uː ɳ k n a r
korp	k ɔ r p
korshänvisning	k ɔ˧˩ r s h ɛː˥˩ n ʋ iː s n ɪ ŋ
kort	k ɔ r t
kort	k ʊ r t
korttålärka	k ɔ r t oː l ɛ r k a
kost	k ɔ s t
kostpris	k ɔ s t p r iː s
koxik	k ʊ k s ɪ k
koyot	k ʊ j oː t
krabba	k r a b a
krabbis	k r ɑː b iː s
kraftfull	k r a f t f ɵ l
kragtrapp	k r ɑː ɡ t r a p
kran	k r ɑː n
krans	k r a n s
krans	k r ɑː n s
krav	k r ɑː ʋ
kretensisk	k r ɛ t ɛ n s ɪ s k
kretsschema	k r ɛ t s ɧ eː m a
krig	k r iː ɡ
kristianstad	k r ɪ ɧ a n s t a
kristina	k r ɪ s t iː˧˩ n a˥˩
krita	k r iː˧˩ t a˥˩
krog	k r uː ɡ
krokan	k r oː k ɑː n
krokan	k r ɔ k ɑː n
krokan	k r ʊ k ɑː n
krom	k r oː m
krona	k r uː n a
kronor	k r uː n ʊ r
kropp	k r ɔ p
kruka	k r ʉː k a
krusbär	k r ʉː s b ɛː r
krusbär	k r ʉː˧˩ s b ɛː˥˩ r
kröka	k r øː k a
kuba	k ʉː b a
kudde	k ɵ d d ɛ
kuf	k ʉː f
kuk	k ʉː k
kuksugare	k ʉː˧˩ k s ʉː˥˩ ɡ a r ɛ
kul	k ʉː l
kuling	k ʉː l ɪ ŋ
kull	k ɵ l
kulör	k ɵ l øː r
kunde	k ɵ n d eː
kung	k ɵ ŋ
kungsfiskare	k ɵ ŋ s f ɪ s k a r ɛ
kungsfågel	k ɵ ŋ s f oː ɡ ɛ l
kungsfågelsångare	k ɵ ŋ s f oː ɡ ɛ l s ɔ ŋ a r ɛ
kunna	k ɵ n a
kur	k ʉː r
kurr	k ɵ r
kurs	k ʉː r s
kuse	k ʉː˧˩ s ɛ˥˩
kusin	k ɵ s iː n
kustlabb	k ɵ s t l a b
kustpipare	k ɵ s t p iː p a r ɛ
kustsnäppa	k ɵ s t s n ɛ p a
kuta	k ʉː t a
kuttrasju	k ɵ t r a ɧ ʉː
kuvert	k ɵ ʋ ɛː r
kvalitet	k ʋ a l ɪ t eː
kvar	k ʋ ɑː r
kvarter	k ʋ a r t eː r
kvasar	k ʋ a s ɑː r
kvicksilver	k ʋ ɪ k s ɪ l ʋ ɛ r
kvinna	k ʋ ɪ n a
kvinnan	k ʋ ɪ n a n
kvinnor	k ʋ ɪ n ʊ r
kvist	k ʋ ɪ s t
kvitta	k ʋ ɪ t a
kvälja	k ʋ ɛ l j a
kväll	k ʋ ɛ l
kvänska	k ʋ ɛː˧˩ n s k a˥˩
kväve	k ʋ ɛː ʋ ɛ
kyckling	ɕ ʏ k l ɪ ŋ
kyrka	ɕ ø˧˩ r k a˥˩
kyrka	ɕ ʏ˧˩ r k a˥˩
kysk	ɕ ʏ s k
kyskhet	ɕ ʏ s k h eː t
kyss	ɕ ʏ s
kyssa	ɕ ʏ s a
käck	ɕ ɛ k
käftis	ɕ ɛ f t ɪ s
käk	ɕ ɛː k
käka	ɕ ɛ k a
käke	ɕ ɛː˧˩ k ɛ˥˩
källa	ɕ ɛ l a
källare	ɕ ɛ l a r ɛ
källing	ɕ ɛ˧˩ l ɪ˥˩ ŋ
känd	ɕ ɛ n d
känga	ɕ ɛ ŋ a
känna	ɕ ɛ n n a
kännspak	t ɕ ɛ n s p ɑː k
kännspak	ɕ ɛ˧˩ n s p ɑː˥˩ k
känsla	ɕ ɛ n s l a
känt	ɕ ɛ n t
käpp	ɕ ɛ p
kär	ɕ ɛː r
kära	ɕ ɛː r a
kärl	ɕ ɛː r l
kärlek	ɕ ɛː r l eː k
kärrhök	ɕ ɛ r h øː k
kärrsnäppa	ɕ ɛ r s n ɛ p a
kärrsångare	ɕ ɛ r s ɔ ŋ a r ɛ
kärrtärna	ɕ ɛ r t æː r n a
kål	k oː l
kålrabbi	k oː˧˩ l r a˥˩ b ɪ
kår	k oː r
kåt	k oː t
kö	k øː
köa	k øː˧˩ a˥˩
kök	ɕ øː k
kökkenmödding	k œ˧˩ k ɛ˥˩ n m œ d ɪ ŋ
köl	ɕ øː l
kölna	ɕ øː˧˩ l n a˥˩
kön	k øː n
kön	ɕ øː n
köp	ɕ øː p
köpa	ɕ øː p a
köpenhamn	ɕ øː p ɛ n h a m n
kör	k œː r
kör	ɕ œː r
köra	k œː r a
köra	ɕ œː r a
körandas	k øː˧˩ r a˥˩ n d a s
körandning	k øː˧˩ r a˥˩ n d n ɪ ŋ
kött	ɕ œ t
köttbulle	ɕ ø t b ɵ l ɛ
köttslig	ɕ œ t s l ɪ ɡ
la	l a
la	l ɑː
laboratorium	l a b ʊ r a t uː r ɪ ɵ m
lade	l ɑː d ɛ
ladugård	l a ɡ ɔ r d
ladugård	l ɑː ɡ ɔ r d
ladugård	l ɑː˧˩ d ɵ˥˩ ɡ oː r d
lager	l ɑː ɡ ɛ r
lagom	l ɑː ɡ ɔ m
lagt	l a k t
lagts	l a k t s
lagård	l a˥˧ ɡ ɔ˩ ɖ
lagård	l ɑː˥˧ ɡ ɔ˩ ɖ
laja	l a˧˩ j a˥˩
lajbans	l a j b a n s
lakan	l ɑː k a n
lakrits	l a˥˧ k r ɪ˩ s
lakrits	l ɑː˥˧ k r ɪ˩ s
lamm	l a m
lammgam	l a m ɡ ɑː m
lammkött	l a m ɕ œ t
landkrabba	l a n d k r a b a
landskapsdjur	l a˧˩ n d s k ɑː˥˩ p s j ʉː r
landskronit	l a n d s k r ʊ n iː t
lantbrevbärare	l a˧˩ n t b r eː˥˩ ʋ b ɛː r a r ɛ
lanterna	l a n t æː ɳ a
lappmes	l a p m eː s
lappuggla	l a p ɵ ɡ l a
larv	l a r ʋ
lasagne	l a s a n j
lastförskjutningsnät	l a˧˩ s t f øː˥˩ r ɧ ʉː t n ɪ ŋ s n ɛː t
lattja	l a˧˩ t ɕ a˥˩
lattjo	l a t ɕ ʊ
lavoar	l a ʋ w a r
lavskrika	l ɑː˧˩ ʋ s k r iː˥˩ k a
layout	l ɛ j a ʊ t
le	l eː
leddjur	l eː d j ʉː r
ledig	l eː d ɪ ɡ
ledsen	l ɛ s ɛ n
ledsna	l ɛ˧˩ s n a˥˩
leende	l eː ɛ n d ɛ
legend	l eː ɡ eː n d
legitim	l ɛ ɡ ɪ t iː m
lego	l eː ɡ uː
leidenflaska	l ɛ j d ɛ n f l a s k a
leif	l ɛ j f
lemur	l ɛ m ʉː r
lesbisk	l ɛ s b ɪ s k
less	l ɛ s
lettiska	l ɛ t ɪ s k a
lev	l eː ʋ
leva	l eː˧˩ ʋ a˥˩
leverpastej	l eː ʋ ɛ r p a s t ɛ j
lian	l iː aː n
lie	l iː ɛ
lik	l iː k
lillejulafton	l ɪ l ɛ j ʉː l a f t ɔ n
lin	l iː n
lina	l iː˧˩ n a˥˩
lindgren	l ɪ n d ɡ r eː n
lindgren	l ɪ ŋ ɡ r eː n
lingon	l ɪ˧˩ ŋ ɔ˥˩ n
lingonsylt	l ɪ˧˩ ŋ ɔ˥˩ n s ʏ l t
linnea	l ɪ n eː˧˩ a˥˩
linnéa	l ɪ n eː˧˩ a˥˩
lisa	l iː˧˩ s a˥˩
lisas	l iː˧˩ s a˥˩ s
lita	l iː t a
litauiska	l ɪ t a ʊ ɪ s k a
liten	l iː˧˩ t ɛ˥˩ n
litium	l iː t s ɪ ɵ m
liv	l iː ʋ
livskvalitet	l iː ʋ s k ʋ a l iː t eː t
ljud	j ʉː d
ljuga	j ʉː˧˩ ɡ a˥˩
ljungby	j ɵ˧˩ ŋ b ʏ˥˩
ljungpipare	j ɵ ŋ p iː p a r ɛ
ljus	j ʉː s
ljushyllt	j ʉː s h ʏ l t
lo	l uː
lob	eː l uː b eː
lob	l uː b
lob	l ɔ b
loge	l oː ɧ
loge	l uː˧˩ ɡ ɛ˥˩
lom	l ʊ m
london	l ɔ n d ɔ n
lopp	l ɔ p
lounge	l a˥˧ ʊ˩ n d ʂ
lounge	l uː˧˩ ɵ˥˩ ŋ ɛ
lounges	l uː ɵ ŋ ɛ s
lov	l oː ʋ
lov	l uː ʋ
lucia	l ɵ s iː a
luden	l ʉː d ɛ n
lugn	l ɵ ŋ n
lunch	l ɵ n ɧ
lunchdisco	l ɵ˧˩ ɧ d ɪ˥˩ s k ʊ
lunchrast	l ɵ˧˩ n ɧ r a˥˩ s t
lund	l ɵ n d
lundensisk	l ɵ n d ɛ n s ɪ s k
lundgren	l ɵ˥˧ n d ɡ r eː˩ n
lundgren	l ɵ˧˩ n d ɡ r eː˥˩ n
lundsångare	l ɵ n d s ɔ ŋ a r ɛ
lussekatt	l ɵ s ɛ k a t
lycka	l ʏ k a
lycklig	l ʏ k l ɪ ɡ
lydnad	l yː d n a d
lymfocyt	l ʏ m f ʊ s yː t
lyxhotell	l ʏ k s h ʊ t ɛ l
läcka	l ɛ k a
läder	l eː d ɛ r
läder	l ɛː d ɛ r
läger	l ɛː ɡ ɛ r
lägga	l ɛ ɡ a
län	l ɛː n
länge	l ɛ ŋ ɛ
längs	l ɛ ŋ s
lär	l ɛː r
lära	l æː r a
läs	l ɛː s
läsa	l ɛː s a
läser	l ɛ s ɛ r
läsesal	l ɛː˧˩ s ɛ˥˩ s ɑː l
läsk	l ɛ s k
läska	l ɛ s k a
läsuttal	l ɛː˧˩ s ʉ˥˩ t t ɑː l
lätt	l ɛ t
lätting	l ɛ˧˩ t ɪ˥˩ ŋ
låg	l oː ɡ
långsam	l ɔ˧˩ ŋ s a˥˩ m
långt	l ɔ ŋ t
långtåsnäppa	l ɔ ŋ t oː s n ɛ p a
långvarig	l ɔ ŋ ʋ ɑː r ɪ ɡ
låt	l oː t
låta	l oː t a
lögn	l œ ŋ n
löneslav	l øː n ɛ s l ɑː ʋ
lönndom	l œ˧˩ n d ʊ˥˩ m
löpa	l øː p a
lördag	l øː r d ɑː ɡ
lösen	l øː s ɛ n
lövverk	l øː ʋ ʋ ɛ r k
mack	m a k
macka	m a˧˩ k a˥˩
mage	m ɑː˧˩ ɡ ɛ˥˩
magnesium	m a ŋ n eː s ɪ ɵ m
magnoliaskogssångare	m a ɡ n uː l ɪ j a s ɡ ʊ ɡ s ɔ ŋ a r ɛ
magnus	m a˥˧ ŋ n ɵ˩ s
maj	m a j
majoritet	m a j oː r ɪ t eː t
maka	m ɑː k a
make	m ɑː k ɛ
mal	m ɑː l
mall	m a l
mallis	m a˥˧ l ɪ˩ s
malmö	m a l m øː
malmöit	m a l m ø iː t
malte	m a˧˩ l t ɛ˥˩
malört	m ɑː˧˩ l œ˥˩ r t
mambo	m a m b ʊ
mambo	m a˧˩ m b uː˥˩
mamsell	m a m z ɛ l
man	m ɑː n
manen	m ɑː n ɛ n
manet	m a n eː t
manga	m a ŋ ɡ a
mangan	m a ŋ ɡ ɑː n
mango	m a ŋ ɡ ʊ
manick	m a n ɪ k
mannen	m a n ɛ n
manöver	m a n øː ʋ ɛ r
margareta	m a r ɡ a r eː˧˩ t a˥˩
margarin	m a r ɡ a r iː n
maria	m a r iː˧˩ a˥˩
marika	m a r iː˧˩ k a˥˩
mark	m a r k
mark	m a r k ɛ r
marknaden	m a r k n a d ɛ n
marknaden	m a r k n a n
mars	m a r s
mars	m a ʂ
marsch	m a r ɧ
maskin	m a ɧ iː n
maskros	m a s k r uː s
masktörnskata	m a s k t øː r n s k ɑː t a
massa	m a s a
massage	m a s ɑː ɧ
mat	m ɑː t
matcha	m a˧˩ t ɕ a˥˩
matematik	m a t ɛ m a t iː k
matsäck	m a˧˩ s ɛ˥˩ k
matsäck	m ɑː˧˩ t s ɛ˥˩ k
matt	m a t
mattant	m ɑː˧˩ t t a˥˩ n t
mattias	m a t iː a s
meckig	m eː k ɪ ɡ
med	m eː d
med	m ɛː d
medarbetare	m eː d a r b eː t a r ɛ
meddela	m eː d d eː l a
meddelande	m eː d eː l a n d eː
medelhavstrut	m eː d ɛ l h a ʋ s t r ʉː t
medhjälpare	m eː d j ɛ l p a r eː
medicin	m ɛ d ɪ s iː n
megafon	m ɛ ɡ a f oː n
mejsel	m ɛ j s ɛ l
mem	m eː m
men	m eː n
men	m ɛ n
meningslös	m eː n ɪ ŋ s l øː s
meningslösa	m eː n ɪ ŋ s l øː s a
mens	m eː n s
mens	m ɛ n s
mentalesiska	m ɛ n t a l eː s ɪ s k a
meny	m ɛ n yː
mer	m eː r
merkurius	m ɛ r k ʉː r ɪ ɵ s
messmör	m eː˧˩ s s m øː˥˩ r
messmör	m ɛ˧˩ s s m øː˥˩ r
meter	m eː t ɛ r
metonym	m ɛ t ɔ n yː m
metonym	m ɛ t ʊ n yː m
meänkieli	m eː ɛ n k ɪ ɛ l ɪ
middag	m ɪ d a
middag	m ɪ d ɑː ɡ
midsommar	m iː˧˩ d s ɔ˥˩ m a r
midsommar	m ɪ˧˩ d s ɔ˥˩ m a r
midsommar	m ɪ˧˩ s ɔ˥˩ m a r
mig	m a j
mig	m ɛ j
mikael	m iː k aː eː l
miklagård	m iː k l a ɡ oː r d
mil	m iː l
mildra	m ɪ l d r a
miljard	m ɪ l j ɑː ɖ
miljon	m ɪ l j uː n
miljö	m ɪ l j øː
millimeter	m ɪ l ɪ m eː t ɛ r
min	m iː n
mina	m iː n a
mineral	m iː n ɛ r aː l
ministerstyre	m ɪ n ɪ s t ɛ r s t yː r ɛ
minnesgod	m ɪ˧˩ n ɛ˥˩ s ɡ uː d
miombomes	m ɪ j ɔ m b ɔ m eː s
missbrukare	m ɪ˧˩ s b r ʉː˥˩ k a r ɛ
mission	m ɪ ɧ uː n
mitt	m ɪ t
mittemot	m ɪ t eː m uː t
mjölk	m j œ l k
mod	m uː d
modevisning	m uː d ɛ ʋ iː s n ɪ ŋ
mojäng	m ʊ j ɛ ŋ
moll	m ɔ l
moln	m oː l n
moln	m ɔ l n
molybden	m ɔ l ʏ b d eː n
monaco	m ɔ n a k ʊ
mongo	m ɔ ŋ ɡ ʊ
mongolpipare	m ɔ ŋ ɡ ʊ l p iː p a r ɛ
monoteist	m ɔ n ʊ t ɛ ɪ s t
monument	m oː n ɵ m ɛ n t
mor	m uː r
morbror	m ʊ r b r ʊ r
mord	m uː r d
mord	m uː ɖ
morgnar	m oː˧˩ r n a˥˩ r
morgnarna	m oː˧˩ ɳ a˥˩ ɳ a
morgon	m ɔ˧˩ r ɡ ɔ˥˩ n
morkulla	m uː r k ɵ l a
mors	m ɔ r s
morsa	m ɔ˧˩ r s a˥˩
morsa	m ʊ˧˩ r s a˥˩
morse	m ɔ˧˩ r s e˥˩
morsning	m ɔ r s n ɪ ŋ
moscha	m ɔ ɕ a
moskva	m ʊ s k ʋ ɑː
mosnäppa	m uː s n ɛ p a
moster	m ʊ s t ɛ r
mot	m uː t
motgift	m uː t j iː f t
motion	m ɔ t ɧ uː n
motion	m ʊ t ɧ uː n
motorcykelhjälm	m uː t ɔ r s ʏ k ɛ l j ɛ l m
motsade	m uː˧˩ t s ɑː˥˩ d ɛ
muck	m ɵ k
mujka	m ʉː j k ɑː
mula	m ʉː˧˩ l a˥˩
mull	m ɵ l
mumie	m ʉː m ɪ ɛ
mumrik	m ɵ m r ɪ k
mun	m ɵ n
mundiarré	m ɵ˧˩ n d ɪ˥˩ a r eː
mur	m ʉː r
murpelare	m ʉː˧˩ r p eː˥˩ l a r eː
mus	m ʉː s
museer	m ɵ s eː ɛ r
museum	m ɵ s eː ɵ m
musik	m ʉː s iː k
muskedunder	m ɵ s k ɛ d ɵ n d ɛ r
muslim	m ɵ s l iː m
musseron	m ɵ s ɛ r ɔ n
must	m ɵ s t
mycket	m ʏ k ɛ t
mygga	m ʏ˧˩ ɡ a˥˩
myla	m yː˧˩ l a˥˩
mynning	m ʏ n ɪ ŋ
mynt	m ʏ n t
myrsnäppa	m yː r s n ɛ p a
myrspov	m yː r s p uː ʋ
mysa	m yː s a
mysig	m yː s ɪ ɡ
mystisk	m ʏ s t ɪ s k
myt	m yː t
mäkla	m ɛː˧˩ k l a˥˩
mäkla	m ɛ˧˩ k l a˥˩
mäktig	m ɛ˧˩ k t ɪ˥˩ ɡ
män	m ɛ n
människa	m ɛ n ɪ ɧ a
mänsklig	m ɛ˧˩ n s k l ɪ˥˩ ɡ
märklig	m æ˧˩ r k l ɪ˥˩ ɡ
mästare	m ɛ s t a r ɛ
mäster	m ɛ s t ɛ r
mästerskap	m ɛ˧˩ s t e˥˩ r s k ɑː p
mäta	m ɛː t a
mål	m oː l
måla	m oː l a
månad	m oː n a d
måndag	m ɔ n d a
måndag	m ɔ n d ɑː ɡ
måne	m oː n ɛ
mångata	m oː ŋ ɡ ɑː t a
månsing	m ɔ˧˩ n s ɪ˥˩ ŋ
mårka	m ɔ˧˩ r k a˥˩
mårtensgås	m ɔ r t ɛ n ɡ oː s
måttbestämd	m ɔ˧˩ t b ɛ˥˩ s t ɛ m d
mög	m øː ɡ
mögel	m øː ɡ ɛ l
mögel	m œ ɡ ɛ l
möjlig	m ø j l iː ɡ
mölla	m œ˧˩ l a˥˩
möp	m øː p
mörk	m øː r k
mötesplats	m øː˧˩ t ɛ˥˩ s p l a t s
nacka	n a˧˩ k a˥˩
nackskinn	n a k ɧ ɪ n
nafs	n a f s
nagel	n ɑː ɡ ɛ l
namn	n a m n
nasa	n ɑː˧˩ s a˥˩
nasare	n ɑː˧˩ s a˥˩ r ɛ
nation	n a t ɧ uː n
nationalist	n a t ɧ ʊ n a l ɪ s t
nationell	n a t ɧ ʊ n ɛ l
nato	n ɑː t ʊ
natrium	n ɑː t r ɪ ɵ m
natt	n a t
natthäger	n a t h ɛ ɡ ɛ r
ned	n eː d
neder	n ɛ d ɛ r
nederländerna	n e˧˩ d ɛ˥˩ r l ɛ n d ɛ ɲ a
nedladdning	n eː˧˩ d l a˥˩ d n ɪ ŋ
nej	n ɛ j
nektarin	n ɛ k t a r iː n
nellie	n ɛ˥˧ l ɪ˩
nelly	n ɛ˥˧ l ʏ˩
neodym	n eː ʊ d yː m
neon	n ɛ oː n
nepalesisk	n ɛ p a l eː s ɪ s k
neptunium	n ɛ p t ʉː n ɪ ɵ m
neptunus	n ɛ p t ʉː n ɵ s
ner	n eː r
neutral	n eː ɵ t r ɑː l
neutron	n eː ɵ t r oː n
ni	n iː
nicke	n ɪ˧˩ k ɛ˥˩
niger	n iː ɡ ɛ r
nigeria	n ɪ ɡ eː r ɪ a
nigger	n ɪ ɡ eː r
nilgås	n iː l ɡ oː s
nim	n ɪ m
nimma	n ɪ˧˩ m a˥˩
nio	n iː ɛ
nio	n iː ʊ
nionde	n iː ɔ n d ɛ
nittio	n ɪ˧˩ t ɪ˥˩
nittio	n ɪ˧˩ t ɪ˥˩ ʊ
nitton	n ɪ t ɔ n
nja	n j a
nja	n j ɑː
njalla	n j a l a
njalla	n j a˧˩ l a˥˩
njure	n j ʉː˧˩ r ɛ˥˩
njuta	n j ʉː˧˩ t a˥˩
nobba	n ɔ˧˩ b a˥˩
nobben	n ɔ b ɛ n
nobel	n ʊ b ɛ l
noll	n ɔ l
nominativ	n ʊ m ɪ n a t iː ʋ
nord	n uː ɖ
nordbo	n uː˧˩ r d b uː˥˩
nordkorea	n uː˧˩ ɖ k ʊ˥˩ r eː a
nordsångare	n uː r d s ɔ ŋ a r ɛ
norge	n ɔ r j ɛ
norr	n ɔ r
norrmalmstorgssyndrom	n ɔ r m a l m s t ɔ˧˩ r j s s ʏ˥˩ n d r oː m
norska	n ɔ˧˩ ʂ k a˥˩
not	n uː t
november	n ʊ ʋ ɛ m b ɛ r
nu	n ʉː
nummer	n ɵ˥˧ m ɛ˩ r
nunatak	n ʉː n a t a k
nusvenska	n ʉː˧˩ s ʋ ɛ˥˩ n s k a
ny	n yː
nyckel	n ʏ k ɛ l
nying	n yː˧˩ ɪ˥˩ ŋ
nypon	n yː p ɔ n
nyps	n yː p s
nyps	n ʏ p s
nyss	n ʏ s
nyttig	n ʏ˧˩ t ɪ˥˩ ɡ
nytänkande	n yː˧˩ t ɛ˥˩ ŋ k a n d eː
nä	n ɛː
näbbdjur	n ɛ b j ʉː r
nämen	n ɛ m ɛ n
nännas	n ɛ˧˩ n a˥˩ s
näsa	n ɛː s a
nästkusin	n ɛ s t k ɵ s iː n
nästkusin	n ɛ˧˩ s t k ɵ˥˩ s iː n
nätter	n ɛ t ɛ r
någon	n oː ɡ ɔ n
någon	n ɔ n
något	n oː ɡ ɔ t
något	n ɔ t
några	n oː ɡ r a
nålginst	n oː l ɡ ɪ n s t
nåt	n oː t
nåt	n ɔ t
nått	n ɔ t
nödrim	n øː d r ɪ m
nödvändig	n øː d ʋ ɛ n d ɪ ɡ
nödvändighet	n øː d ʋ ɛ n d ɪ ɡ h eː t
nörd	n øː r d
nördig	n øː r d ɪ ɡ
nöt	n øː t
nötkråka	n øː t k r oː k a
nött	n œ t
o	oː
o	uː
o	ɔ
o	ʊ
obelisk	oː b ɛ l ɪ s k
objekt	ɔ b j ɛ k t
objektiv	ɔ b j ɛ k t iː ʋ
obskyr	ɔ b s k yː r
och	ɔ
och	ɔ k
ock	ɔ k
offert	ɔ f æ ʈ
offert	ʊ f æ ʈ
officiell	ɔ f iː s j ɛ l
offside	ɔ f s a j d
ogge	ɔ˧˩ ɡ ɛ˥˩
ogilla	uː˧˩ j ɪ˥˩ l a
ohemul	uː h eː m ʉː l
ohygglig	ʊ h ʏ ɡ l ɪ ɡ
okapabel	uː˧˩ k a˥˩ p ɑː b ɛ l
okej	ɔ k ɛ j
okej	ʊ k ɛ j
oktober	ʊ k t uː b ɛ r
oktober	ʊ k t ʊ b ɛ r
okynnesäta	uː˧˩ ɕ ʏ˥˩ n ɛ s ɛː t a
olaglig	uː l ɑː ɡ l ɪ ɡ
olle	ʊ˧˩ l ɛ˥˩
ollon	ɔ l ɔ n
olof	uː l ɔ f
olof	uː l ɔ ʋ
olof	uː˧˩ l ɔ˥˩ f
olof	uː˧˩ l ɔ˥˩ ʋ
olycka	uː l ʏ k a
olycklig	uː˧˩ l ʏ˥˩ k l ɪ ɡ
om	ɔ m
ombudsman	ɔ m b ʉː d s m a n
omfång	ɔ m f ɔ ŋ
omljud	ɔ˧˩ m j ʉː˥˩ d
omständig	ɔ˧˩ m s t ɛ˥˩ n d ɪ ɡ
omständlig	ɔ˧˩ m s t ɛ˥˩ n d l ɪ ɡ
omöjlig	uː˧˩ m ø˥˩ j l ɪ ɡ
onsdag	ʊ n s d a
onsdag	ʊ n s d ɑː ɡ
orange	ʊ r a n ɕ
orange	ʊ r a ŋ ɧ
ord	uː r d
ordbok	uː r d b uː k
orden	uː r d ɛ n
orden	ɔ r d ɛ n
ordentlig	ʊ ɖ ɛ n t l ɪ ɡ
ordentlig	ʊ ɖ ɛ ŋ k l ɪ ɡ
order	ɔ r d ɛ r
ordning	ɔ r d n ɪ ŋ
orientering	ɔ r j ɛ n t eː˥˧ r ɪ˩ ŋ
orientseglare	ɔ r ɪ j ɛ n t s eː ɡ l a r ɛ
orienttalgoxe	oː r iː j ɛ n t a l j oː k s eː
orientvadarsvala	ɔ r j ɛ n t ʋ ɑː d a r s ʋ ɑː l a
orka	ɔ r k a
orkan	ʊ r k ɑː n
orm	ʊ r m
orma	ʊ r m a
ormörn	ʊ r m øː r n
ort	ʊ ʈ
osa	uː˧˩ s a˥˩
oscar	ɔ˥˧ s k a˩ r
oskar	ɔ˥˧ s k a˩ r
oslo	ʊ s l ʊ
oss	ɔ s
osäker	uː s ɛː k ɛ r
otagbar	uː˧˩ t ɑː˥˩ ɡ b ɑː r
otålig	uː˧˩ t oː˥˩ l ɪ ɡ
ovan	oː ʋ a n
ovan	uː ʋ ɑː n
ove	uː˧˩ ʋ ɛ˥˩
overall	ɔ ʋ ɛ r a l
overall	ɔ ʋ ɛ r oː l
overall	ʊ ʋ ɛ r a l
overall	ʊ ʋ ɛ r oː l
oxid	ɔ k s iː d
oändlig	ʊ ɛ n d l ɪ ɡ
page	p ɑː ɧ
paj	p a j
paket	p a k eː t
palats	p a l a t s
palladium	p a l ɑː d ɪ ɵ m
palmduva	p a l m d ʉː ʋ a
paludarium	p ɑː l ɵ d ɑː r ɪ ɵ m
panda	p a n d a
panpsykism	p a˧˩ n p s yː˥˩ k ɪ s m
panteon	p a n t eː ʊ n
pantoffel	p a n t ɔ f ɛ l
papegojalka	p a p ɛ ɡ ɔ j a l k a
papper	p a˧˩ p ɛ˥˩ r
paraply	p a r a p l y
parentes	p a r a n t eː s
parentes	p a r a ŋ t eː s
parentes	p a r ɛ n t eː s
paris	p a r iː s
part	p ɑː ʈ
partiell	p a r ɕ ɛ l
passage	p a s ɑː ɧ
passage	p a s ɑː ʂ
passagerare	p a s a ɧ eː˧˩ r a˥˩ r ɛ
pastej	p a s t ɛ j
patent	p a t ɛ n t
paul	p oː l
paulina	p a ʊ l iː˧˩ n a˥˩
paus	p a ʊ s
pava	p ɑː˧˩ ʋ a˥˩
pax	p a k s
ped	p eː d
peda	p eː d
pekoral	p eː k ʊ r ɑː l
peng	p ɛ ŋ
pension	p a n ɧ uː n
penultima	p eː n ɵ l t ɪ m a
pep	p eː p
peppar	p ɛ p a r
period	p ɛ r j uː d
persilja	p ɛ r s ɪ l j a
person	p ɛ ʂ uː n
personlig	p ɛ ʂ oː n l ɪ ɡ
personligen	p ɛ r s uː n l ɪ ɡ ɛ n
picka	p ɪ˧˩ k a˥˩
pigg	p iː ɡ
pille	p ɪ l ɛ
pin	p iː n
pin	p ɪ n
pinje	p ɪ n j ɛ
pipare	p iː p a r ɛ
piparsnäppa	p iː p a r s n ɛ p a
piper	p iː p ɛ r
pirog	p ɪ r oː ɡ
pizza	p ɪ˧˩ t s a˥˩
pjäs	p j ɛː s
pladdra	p l a˧˩ d r a˥˩
planta	p l a n t a
platina	p l ɑː t ɪ n a
platt	p l a t
plocka	p l ɔ˧˩ k a˥˩
plundring	p l ɵ n d r ɪ ŋ
pluskvamperfekt	p l ɵ s k ʋ a m p ɛ r f ɛ k t
podd	p ɔ d
pojk	p ɔ j k
pojkar	p ɔ j k a r
pojke	p ɔ˧˩ j k ɛ˥˩
pokal	p ʊ k ɑː l
polarvarg	p ʊ l ɑː˧˩ r ʋ a˥˩ r j
politik	p ʊ l ɪ t iː k
politiker	p ʊ l iː t ɪ k ɛ r
politiker	p ʊ l ɪ t iː k ɛ r
polska	p oː˧˩ l s k a˥˩
polska	p ɔ˧˩ l s k a˥˩
ponke	p ɔ˧˩ ŋ k ɛ˥˩
pool	p uː l
post	p ɔ s t
postavi	p ɔ s t ɑː ʋ iː
potatiskorv	p ʊ t ɑː˧˩ t ɪ˥˩ s k ɔ r ʋ
praktejder	p r a k t ɛ j d ɛ r
praktmes	p r a k t m eː s
prat	p r ɑː t
prata	p r ɑː t a
precis	p r ɛ s iː s
precis	p r ɛ s ɪ s
presens	p r eː s ɛ n s
present	p r eː s eː n t
pressmeddelande	p r ɛ˧˩ s m eː˥˩ d eː l a n d ɛ
pretentiös	p r ɛ t a n ɧ øː s
pretentiöst	p r ɛ t a n ɧ œː s t
prilla	p r ɪ l a
princip	p r ɪ n s iː p
pris	p r iː s
privatjet	p r ɪ ʋ ɑː˧˩ t j ɛ˥˩ t
problem	p r ʊ b l eː m
procent	p r ʊ s ɛ n t
process	p r ʊ s ɛ s
prognos	p r ɔ ɡ n oː s
prosa	p r uː s a
proton	p r ʊ t oː n
prutgås	p r ʉː t ɡ oː s
prutt	p r ɵ t
prutta	p r ɵ t a
prärielöpare	p r ɛː r ɪ j ɛ l øː p a r eː
prärietrana	p r ɛː r ɪ j ɛ t r ɑː n a
prärievarg	p r ɛː˧˩ r ɪ˥˩ ɛ ʋ a r j
pröva	p r øː ʋ a
prövning	p r ø˧˩ ʋ n ɪ˥˩ ŋ
puka	p ʉː˧˩ k a˥˩
pulka	p ɵ l k a
pumla	p ɵ˧˩ m l a˥˩
pungmes	p ɵ ŋ m eː s
punkt	p ɵ ŋ k t
punktlig	p ɵ ŋ k t l ɪ ɡ
punktlig	p ɵ ŋ t l ɪ ɡ
purpurhäger	p ɵ r p ɵ r h ɛ ɡ ɛ r
pusha	p ɵ˧˩ ɧ a˥˩
pusha	p ʊ˧˩ ɧ a˥˩
puss	p ɵ s
pussa	p ɵ s a
pys	p yː s
pyttipanna	p ʏ t ɪ p a˧˩ n a˥˩
pära	p æː˧˩ r a˥˩
päron	p æː r ɔ n
på	p oː
påg	p oː ɡ
pålägg	p oː˧˩ l ɛ˥˩ ɡ
påskas	p ɔ˧˩ s k a˥˩ s
påskkärring	p ɔ˧˩ s k ɕ ɛ˥˩ r ɪ ŋ
påskmust	p ɔ˧˩ s k m ɵ˥˩ s t
påtår	p oː t oː r
pöl	p øː l
rabatt	r a b a t
rabba	r a˧˩ b a˥˩
rabbemos	r a˧˩ b ɛ˥˩ m uː s
rabbis	r a b ɪ s
radon	r a d oː n
ragge	r a˧˩ ɡ ɛ˥˩
ragnarök	r a ŋ n a r øː k
rajd	r a j d
rallhäger	r a l h ɛ ɡ ɛ r
ram	r ɑː m
rand	r a n d
ras	r ɑː s
rationell	r a t ɧ ʊ n ɛ l
rauk	r a ʊ k
realisationsvinstbeskattning	r eː a l ɪ s a ɧ uː˧˩ n s ʋ ɪ˥˩ n s t b ɛ s k a t n ɪ ŋ
recept	r ɛ s ɛ p t
red	r eː d
reform	r eː f ɔ r m
regera	r ɛ j eː r a
regering	r ɛ j eː r ɪ ŋ
regi	r ɛ ɧ iː
regim	r ɛ ɧ iː m
regissör	r ɛ ɧ ɪ s øː r
register	r ɛ j ɪ s t ɛ r
registrera	r ɛ j ɪ s t r eː r a
registrera	r ɛ ɡ ɪ s t r eː r a
regn	r ɛ ŋ n
regna	r eː ŋ n a
rejäl	r ɛ j ɛː l
reklam	r ɛ k l ɑː m
reklamera	r ɛ k l a m eː r a
rekommendera	r ɛ k ʊ m ɛ n d eː r a
relation	r ɛ l a ɧ uː n
relativitet	r ɛ l a t ɪ ʋ ɪ t eː t
relativitetsteori	r ɛ l a t ɪ ʋ ɪ t eː˧˩ t s t ɛ˥˩ ʊ r iː
religion	r ɛ l ɪ j uː n
religiös	r ɛ l ɪ ɧ øː s
renommé	r ɛ n ɔ m eː
renommésnyltning	r ɛ n ɔ m eː s n ʏ l t n ɪ ŋ
rent	r eː n t
rep	r eː p
replokal	r eː˧˩ p l ʊ˥˩ k ɑː l
reson	r ɛ s uː n
restaurang	r ɛ s t a ʊ r a ŋ
restaurang	r ɛ s t ɵ r a ŋ
resultat	r ɛ s ɵ l t ɑː t
rev	r eː ʋ
revolution	r ɛ ʋ ʊ l ɵ ɧ uː n
reykjavik	r ɛ˧˩ j k j a˥˩ ʋ iː k
ribbstol	r ɪ˧˩ b s t uː˥˩ l
rik	r iː k
rike	r iː k ɛ
rikssvenska	r ɪ˧˩ k s s ʋ ɛ˥˩ n s k a
riktig	r ɪ˧˩ k t ɪ˥˩ ɡ
ringand	r ɪ ŋ a n d
ringduva	r ɪ ŋ d ʉː ʋ a
ris	r iː s
robert	r oː˥˧ b æ˩ ʈ
robert	r oː˥˧ b ɛ˩ ʈ
rock	r ɔ˥˧ k
roffe	r ɔ˧˩ f ɛ˥˩
rom	r oː m
rom	r ɔ m
rom	r ʊ m
romare	r ʊ˧˩ m a˥˩ r ɛ
ros	r uː s
rosa	r oː s a
rosa	r uː s a
rosenstare	r uː s ɛ n s t ɑː r ɛ
rosentärna	r uː s ɛ n t æː r n a
rosett	r ʊ s ɛ t
roskarl	r uː s k ɑː r l
rostand	r ɔ s t a n d
rostgumpsvala	r ɔ s t ɡ ɵ m p s ʋ ɑː l a
rostmes	r ɔ s t m eː s
rot	r uː t
rotmos	r uː˧˩ t m uː˥˩ s
rotting	r ɔ˧˩ t ɪ˥˩ ŋ
rov	r uː ʋ
rova	r uː˧˩ ʋ a˥˩
ruckel	r ɵ k ɛ l
rulle	r ɵ l ɛ
rum	r uː m
rumänska	r ɵ m ɛ n s k a
russin	r ɵ˧˩ s ɪ˥˩ n
rwanda	r ʋ a˧˩ n d a˥˩
ryska	r ʏ˧˩ s k a˥˩
ryttare	r ʏ t a r eː
räd	r ɛː d
rälig	r ɛː l ɪ ɡ
ränna	r ɛ n a
räv	r ɛː ʋ
rävunge	r ɛː ʋ ɵ ŋ ɛ
rådjur	r oː j ʉː r
råtta	r ɔ t a
röd	r øː
röd	r øː d
rödbena	r øː d b eː n a
rödfalk	r øː d f a l k
rödlök	r øː d l øː k
rödspov	r øː d s p uː ʋ
rödvarg	r øː˧˩ d ʋ a˥˩ r j
rök	r øː k
rökfritt	r øː˧˩ k f r ɪ˥˩ t
rökning	r øː˧˩ k n ɪ˥˩ ŋ
rölleka	r œ l ɛ k a
rörhöna	r øː r h øː n a
rörlig	r œ˧˩ ɭ ɪ˥˩ ɡ
rörsångare	r øː r s ɔ ŋ a r ɛ
röst	r œ s t
rövslickare	r øː˧˩ ʋ s l ɪ˥˩ k a r ɛ
sa	s ɑː
sabla	s ɑː b l a
sabotage	s a b ʊ t ɑː ɧ
sade	s ɑː d ɛ
saft	s a f t
sagt	s a k t
sak	s ɑː k
sakna	s ɑː k n a
saldo	s a l d ʊ
salt	s a l t
sam	s a m
sambo	s a m b ʊ
sambo	s a˧˩ m b uː˥˩
samling	s a˧˩ m l ɪ˥˩ ŋ
samt	s a m t
samtal	s a m t ɑː l
sandig	s a˧˩ n d ɪ˥˩ ɡ
sandlöpare	s a n d l øː p a r eː
sandsnäppa	s a n d s n ɛ p a
sandtärna	s a n d t æː r n a
sandvita	s a n d ʋ iː t a
sareptasenap	s a r ɛ p t a s eː n a p
satan	s ɑː t a n
saturnus	s a t ɵ r n ɵ s
schack	ɧ a k
schampo	ɧ a m p ʊ
schasa	ɧ ɑː˧˩ s a˥˩
schejk	ɧ ɛ j k
schema	ɧ eː m a
schlager	ɧ l ɑː ɡ eː r
schweiz	ɕ ʋ ɛ ɪ t s
se	s eː
sedan	s eː d a n
sedan	s ɛ n
sedel	s eː d ɛ l
seeda	s iː d a
seg	s eː ɡ
seger	s eː ɡ ɛ r
segling	s eː˧˩ ɡ l ɪ˥˩ ŋ
sejour	s ɛ ɧ uː r
selen	s ɛ l eː n
semester	s ɛ m ɛ s t ɛ r
semestrar	s ɛ m ɛ s t r a r
semla	s eː m l ɑː
semla	s e˧˩ m l a˥˩
semla	s ɛ˧˩ m l a˥˩
sen	s eː n
sen	s ɛ n
senapsgul	s eː n a p s ɡ ʉː l
senapssill	s eː˧˩ n a˥˩ p s s ɪ l
sent	s eː n t
september	s ɛ p t ɛ m b ɛ r
serve	s ɵ r ʋ
set	s ɛ t
sett	s ɛ t
sevilla	s ɛ ʋ iː a
sevärd	ɑː ʋ ɧ ʏ ʋ ɛ r d
sex	s ɛ k s
sextio	s ɛ˧˩ k s t ɪ˥˩
sextio	s ɛ˧˩ k s t ɪ˥˩ ʊ
sexton	s ɛ k s t ɔ n
sexualitet	s ɛ k s ɵ a l ɪ t eː t
sexualkunskap	s ɛ k s ɵ ɑː l k ɵ n s k ɑː p
shetlandsöarna	ɧ ɛ t l a n d s øː a ɳ a
shobresvenska	ɕ uː˧˩ b r ɛ˥˩ s ʋ ɛ n s k a
shopping	ɧ ɔ˥˧ p ɪ˩ ŋ
shorts	ɧ oː ʈ s
shorts	ʃ oː ʈ s
sida	s iː d a
sig	s a j
sig	s ɛ j
silkeshäger	s ɪ l k ɛ s h ɛ ɡ ɛ r
sill	s ɪ l
sillgrissla	s ɪ l ɡ r ɪ s l a
silltrut	s ɪ l t r ʉː t
silver	s ɪ l ʋ ɛ r
silvertärna	s ɪ l ʋ ɛ r t æː r n a
simma	s ɪ˧˩ m a˥˩
sin	s iː n
sinfonietta	s ɪ n f ɔ n ɪ ɛ˧˩ t a˥˩
sinnes	s ɪ˧˩ n ɛ˥˩ s
sitar	s ɪ t ɑː r
sitt	s ɪ t
sitta	s ɪ˧˩ t a˥˩
situation	s ɪ t ɵ a ɧ uː n
situation	s ɪ t ʋ a ɧ uː n
sjal	ɧ ɑː l
sjok	ɧ uː k
sju	ɧ ʉː
sjucker	ɧ ɵ k ɛ r
sjuda	ɧ ʉː d a
sjuk	ɧ ʉː k
sjuka	ɧ ʉː˧˩ k a˥˩
sjukdom	ɧ ʉː˧˩ k d ʊ˥˩ m
sjukhus	ɧ ʉː˧˩ k h ʉː˥˩ s
sjukna	ɧ ʉː˧˩ k n a˥˩
sjuksköterska	ɧ ʉː˧˩ k ɧ øː˥˩ t ɛ r s k a
sjunde	ɧ ɵ n d ɛ
sjunga	ɧ ɵ ŋ a
sjunka	ɧ ɵ ŋ k a
sjuttio	ɧ ɵ˧˩ t ɪ˥˩
sjuttio	ɧ ɵ˧˩ t ɪ˥˩ ʊ
sjutton	ɧ ɵ t ɔ n
själ	ɧ ɛː l
själv	ɧ ɛ l ʋ
självklar	ɧ ɛ˧˩ l ʋ k l ɑː˥˩ r
självklarhet	ɧ ɛ˧˩ l ʋ k l ɑː˥˩ r h eː t
sjätte	ɧ ɛ t ɛ
sjö	ɧ øː
sjö	ɧ œ n
sjökalv	ɧ øː˧˩ k a˥˩ l ʋ
sjökvist	ɧ øː˧˩ k ʋ ɪ˥˩ s t
sjöman	ɧ øː m a n
sjön	ɧ œ n
sjöorre	ɧ øː ɔ r ɛ
sjöquist	ɧ øː˧˩ k ʋ ɪ˥˩ s t
sjöqvist	ɧ øː˧˩ k ʋ ɪ˥˩ s t
ska	s k aː
ska	s k ɑː
skabb	s k a b
skakis	s k ɑː˥˧ k ɪ˩ s
skakning	s k ɑː k n ɪ ŋ
skall	s k a l
skam	s k a m
skandium	s k a n d ɪ ɵ m
skapa	s k ɑː p a
skapelse	s k ɑː p ɛ l s ɛ
skatgök	s k ɑː t j øː k
ske	ɧ eː
sked	ɧ eː d
skedand	ɧ eː d a n d
skedstork	ɧ eː d s t ɔ r k
sken	ɧ eː n
skepp	ɧ ɛ p
skepparkrans	ɧ ɛ p a r k r a n s
sket	ɧ eː t
skev	ɧ eː ʋ
skicka	ɧ ɪ k a
skiffer	ɧ ɪ f ɛ r
skiffermes	ɧ ɪ f ɛ r m eː s
skiffertrut	ɧ ɪ f ɛ r t r ʉː t
skildring	ɧ ɪ˧˩ l d r ɪ˥˩ ŋ
skilja	ɧ ɪ l j a
skilling	ɧ ɪ l ɪ ŋ
skillnad	ɧ ɪ l n a d
skina	ɧ iː n a
skinn	ɧ ɪ n
skit	ɧ iː t
skjorta	ɧ ʊ r t a
skjul	ɧ ʉː l
skjuta	ɧ ʉː˧˩ t a˥˩
skjutglad	ɧ ʉː t ɡ l ɑː d
sko	s k uː
skock	s k ɔ k
skogsduva	s k ʊ ɡ s d ʉː ʋ a
skogssnäppa	s k ʊ ɡ s s n ɛ p a
skogsstjärna	s k ʊ k s ɧ ɛː r n a
skola	s k uː l a
skolbespisning	s k uː˧˩ l b ɛ˥˩ s p iː s n ɪ ŋ
skolka	s k ɔ l k a
skolmat	s k uː˧˩ l m ɑː˥˩ t
skolmatsal	s k uː˧˩ l m ɑː˥˩ t s ɑː l
skorsten	s k ɔ˧˩ ʂ t eː˥˩ n
skorstensseglare	s k ɔ ʂ t eː n s eː ɡ l a r ɛ
skotskt	s k ɔ t s k t
skottland	s k ɔ t l a n d
skraj	s k r a j
skribent	s k r ɪ b ɛ n t
skridsko	s k r ɪ˥˧ s k ʊ˩
skrik	s k r iː k
skrikstrandpipare	s k r iː k s t r a n d p iː p a r ɛ
skrikörn	s k r iː k øː r n
skriva	s k r iː ʋ a
skrivmaskin	s k r iː˧˩ ʋ m a˥˩ ɧ iː n
skrivning	s k r iː ʋ n ɪ ŋ
skrota	s k r oː t a
skruv	s k r ʉː ʋ
skrämma	s k r ɛ˧˩ m a˥˩
skräntärna	s k r ɛ n t æː r n a
skula	s k ʉː˧˩ l a˥˩
skull	s k ɵ l
skulle	s k ɵ l eː
skumvin	s k ʉː m ʋ iː n
sky	ɧ yː
skydd	ɧ ʏ d
skyddshjälm	ɧ ʏ d s j ɛ l m
skyddsväg	ɕ yː d s ʋ eː ɡ
skyfall	ɧ yː˧˩ f a˥˩ l
skygg	ɧ ʏ ɡ
skyhög	ɧ yː˩ h øː ɡ
skylt	ɧ ʏ l t
skymma	ɧ ʏ m a
skymning	ɧ ʏ m n ɪ ŋ
skytt	ɧ ʏ t
skytte	ɧ ʏ˧˩ t ɛ˥˩
skytten	ɧ ʏ˥˧ t ɛ˩ n
skytten	ɧ ʏ˧˩ t ɛ˥˩ n
skägg	ɧ ɛ ɡ
skäggdopping	ɧ ɛ ɡ d ɔ p ɪ ŋ
skäggmes	ɧ ɛ ɡ m eː s
skäggtärna	ɧ ɛ ɡ t æː r n a
skäl	ɧ ɛː l
skälig	ɧ ɛː˧˩ l ɪ˥˩ ɡ
skämskudde	ɧ ɛ˧˩ m s k ɵ˥˩ d ɛ
skämt	ɧ ɛ m t
skänka	ɧ ɛ˧˩ ŋ k a˥˩
skär	ɧ æː r
skära	ɧ æː r a
skärfläcka	ɧ ɛː r f l ɛ k a
skärp	ɧ ɛ r p
skärp	ʃ æ r p
skärsnäppa	ɧ ɛː r s n ɛ p a
skåda	s k oː d a
sköld	ɧ œ l d
sköldpadda	ɧ œ l d p a d a
skölja	ɧ œ l j a
skön	ɧ øː n
skönhetssalong	ɧ øː n h eː t s s a l ɔ ŋ
skörbjugg	ɧ œː˧˩ r b j ɵ˥˩ ɡ
sköt	ɧ øː t
sköts	ɧ øː t s
slagsmål	s l a k s m oː l
slaguggla	s l ɑː ɡ ɵ ɡ l a
slangens	s l a ŋ eː n s
sleva	s l eː˧˩ ʋ a˥˩
slitvarg	s l iː˧˩ t ʋ a˥˩ r j
slog	s l uː ɡ
slogs	s l uː k s
slogs	s l uː ɡ s
slogs	s l ʊ k s
slussa	s l ɵ˧˩ s a˥˩
slut	s l ʉː t
sluten	s l ʉː˥˧ t ɛ˩ n
sluten	s l ʉː˧˩ t ɛ˥˩ n
slutrea	s l ʉː˧˩ t r eː˥˩ a
slutspurt	s l ʉː t s p ɵ r t
släkt	s l ɛ k t
slät	s l ɛː t
slå	s l oː
slån	s l oː n
slö	s l øː
slöjd	s l œ j d
slösa	s l øː˧˩ s a˥˩
slöseri	s l øː s ɛ r iː
smarrig	s m a˧˩ r ɪ˥˩ ɡ
smaska	s m a˧˩ s k a˥˩
smaskig	s m a˧˩ s k ɪ˥˩ ɡ
smet	s m eː t
smittkurva	s m ɪ˧˩ t k ɵ˥˩ r ʋ a
smoking	s m oː k ɪ ŋ
smulgubbe	s m ʉː˧˩ l ɡ ɵ˥˩ b ɛ
smultron	s m ɵ l t r ɔ n
smultronställe	s m ɵ˧˩ l t r ɔ˥˩ n s t ɛ l ɛ
smurf	s m ɵ r f
smutsgam	s m ɵ t s ɡ ɑː m
smyg	s m yː ɡ
små	s m oː
småborgare	s m oː˧˩ b ɔ˥˩ r j a r eː
småborgerlig	s m oː˧˩ b ɔ˥˩ r j ɛ r l ɪ ɡ
småborgerlighet	s m oː˧˩ b ɔ˥˩ r j ɛ r l ɪ ɡ h eː t
smådopping	s m oː d ɔ p ɪ ŋ
småkusin	s m oː k ʉː s iː n
småkusin	s m oː˧˩ k ɵ˥˩ s iː n
smålom	s m oː l ʊ m
småskrake	s m oː k r ɑː k ɛ
småskuren	s m oː˧˩ s k ʉː˥˩ r ɛ n
småsnäppa	s m oː s n ɛ p a
småtrapp	s m ɔ t r a p
småtärna	s m oː t æː r n a
smör	s m øː r
smörgås	s m œ r ɡ oː s
smörgås	s m œ r ɡ ɔ s
smörgåsbord	s m œ r ɡ ɔ s b uː r d
smörgåstårta	s m œ˧˩ r ɡ ɔ˥˩ s t oː r t a
snabb	s n a b
snabbt	s n a p t
snacka	s n a k a
snapsvisa	s n a˧˩ p s ʋ iː˥˩ s a
snart	s n ɑː ʈ
snatterand	s n a t ɛ r a n d
snickare	s n ɪ k a r ɛ
snickeri	s n ɪ k ɛ r iː
snickra	s n ɪ k r a
snida	s n iː d a
sno	s n uː
snowboots	s n oː b ɔ t s
snowboots	s n oː ʊ b uː t s
snowboots	s n ɔ b ɔ t s
snowboots	s n ɔ uː b ɔ t s
snudd	s n ɵ d
snus	s n ʉː s
snusa	s n ʉː˧˩ s a˥˩
snusare	s n ʉː˧˩ s a˥˩ r ɛ
snusig	s n ʉː˧˩ s ɪ˥˩ ɡ
snuskhummer	s n ɵ˧˩ s k h ɵ˥˩ m ɛ r
snusmumrik	s n ʉː˧˩ s m ɵ˥˩ m r ɪ k
snutt	s n ɵ t
snygging	s n ʏ˧˩ ɡ ɪ˥˩ ŋ
snylta	s n ʏ˧˩ l t a˥˩
snyltning	s n ʏ˧˩ l t n ɪ˥˩ ŋ
snäll	s n ɛ l
snälla	s n ɛ l a
snäppa	s n ɛ p a
snål	s n oː l
snåljåp	s n oː˧˩ l j oː˥˩ p
snålvarg	s n oː˧˩ l ʋ a˥˩ r j
snö	s n øː
snöga	s n øː˧˩ ɡ a˥˩
snön	s n œ n
social	s oː s iː ɑː l
social	s oː ɧ ɑː l
sockenmål	s ɔ˧˩ k ɛ˥˩ n m oː l
sockenmål	s ʊ˧˩ k ɛ˥˩ n m oː l
soda	s uː˧˩ d a˥˩
sofia	s ʊ f iː˧˩ a˥˩
sol	s uː l
solk	s ɔ l k
solsken	s uː˧˩ l ɧ eː˥˩ n
solvarg	s uː˧˩ l ʋ a˥˩ r j
som	s ɔ m
somaliames	s ɔ m ɑː l j a m eː s
sommar	s ɔ m a r
sommartid	s ɔ m a r t iː d
somras	s ɔ˧˩ m r a˥˩ s
son	s oː n
soppa	s ɔ p a
sorl	s oː r l
sortering	s ɔ r t eː r ɪ ŋ
sortering	s ʊ r t eː r ɪ ŋ
sosse	s ɔ s ɛ
sosse	s ʊ s ɛ
sossig	s ɔ˧˩ s ɪ˥˩ ɡ
sossig	s ʊ˧˩ s ɪ˥˩ ɡ
sot	s uː t
sothöna	s uː t h øː n a
sotis	s uː˥˧ t ɪ˩ s
sottärna	s uː t t æː r n a
sov	s oː ʋ
sova	s oː ʋ a
sovel	s oː ʋ ɛ l
sovjet	s ʊ ʋ j eː˥˧ t
sovjet	s ʊ ʋ j ɛ˥˧ t
sovstad	s oː ʋ s t ɑː d
spanska	s p a˧˩ n s k a˥˩
spara	s p ɑː r a
sparvuggla	s p a r ʋ ɵ ɡ l a
spasm	s p a s m
spegel	s p eː ɡ ɛ l
spel	s p eː l
spela	s p eː l a
spelar	s p eː l a r
spenat	s p ɛ n ɑː t
speta	s p eː˧˩ t a˥˩
spetsbergsgrissla	s p ɛ t s b ɛ r j s ɡ r ɪ s l a
spetsbergsgås	s p ɛ t s b ɛ r j s ɡ oː s
spettekaka	s p ɛ˧˩ t ɛ˥˩ k ɑː k a
spetälska	s p eː t æ l s k a
spik	s p iː k
spis	s p iː s
spisa	s p iː˧˩ s a˥˩
spjut	s p j ʉː t
sport	s p ɔ ʈ
sport	s p ʊ ʈ
spov	s p uː ʋ
spovsnäppa	s p ʊ ʋ s n ɛ p a
sprida	s p r iː d a
sprit	s p r iː t
spruta	s p r ʉː˧˩ t a˥˩
språk	s p r oː k
spurt	s p ɵ r t
spy	s p yː
spänna	s p ɛ n a
spåga	s p oː˧˩ ɡ a˥˩
spö	s p øː
spöke	s p øː˧˩ k ɛ˥˩
spöregn	s p øː˩ r ɛ ŋ n
stad	s t a t s
stad	s t ɑː d
stadig	s t ɑː d ɪ ɡ
stadsbo	s t a˧˩ t s b uː˥˩
stal	s t ɑː l
stamområde	s t a˧˩ m ɔ˥˩ m r oː d ɛ
stat	s t ɑː t
station	s t a ɧ uː n
stationär	s t a t ɧ ʊ n æː r
statlig	s t ɑː t l ɪ ɡ
stav	s t ɑː ʋ
stava	s t ɑː ʋ a
stege	s t eː ɡ ɛ
stel	s t eː l
stenfalk	s t eː n f a l k
stensvala	s t eː n s ʋ ɑː l a
stickelbär	s t ɪ˧˩ k ɛ˥˩ l b ɛː r
stillhet	s t ɪ l h eː t
stjäl	ɧ ɛː l
stjäla	ɧ ɛː l a
stjälk	ɧ ɛ˥˧ l k
stjälpa	ɧ ɛ l p a
stjärt	ɧ ɛ r t
stjärtand	ɧ ɛ ʈ a n d
stockholm	s t ɔ˧˩ k h ɔ˥˩ l m
stockholmssyndrom	s t ɔ˧˩ k h ɔ˥˩ l m s s ʏ n d r oː m
stod	s t uː d
stod	s t uː ɡ
stoft	s t ɔ f t
stol	s t uː l
stomme	s t uː m eː
stor	s t uː r
storlabb	s t uː r l a b
storlom	s t uː r l ʊ m
storm	s t ɔ r m
stormaktstid	s t uː˧˩ r m a˥˩ k t s t iː d
stormfågel	s t ɔ r m f oː ɡ ɛ l
storskrake	s t uː r s k r ɑː k ɛ
storspov	s t uː r s p uː ʋ
stortrapp	s t uː r t r a p
stova	s t oː˧˩ ʋ a˥˩
strandskata	s t r a n d s k ɑː t a
strass	s t r a s
strontium	s t r ɔ n t s ɪ ɵ m
stryka	s t r yː k a
stråla	s t r oː l a
stråle	s t r oː l eː
ström	s t r œ m
strömand	s t r œ m a n d
strömming	s t r œ m ɪ ŋ
stubb	s t ɵ b
stubbstjärtseglare	s t ɵ b ɧ ɛ ʈ s eː ɡ l a r ɛ
student	s t ɵ d ɛ n t
studio	s t ʉː d ɪ ʊ
studsa	s t ɵ t s a
stuga	s t ʉː˧˩ ɡ a˥˩
stulit	s t ʉː l ɪ t
stut	s t ʉː t
stuva	s t ʉː˧˩ ʋ a˥˩
styltlöpare	s t ʏ l t l øː p a r ɛ
styltsnäppa	s t ʏ l t s n ɛ p a
städerska	s t ɛː d ɛ ʂ k a
ställningstagande	s t ɛ˧˩ l n ɪ˥˩ ŋ s t ɑː ɡ a n d ɛ
stämma	s t ɛ m a
stäpp	s t ɛ p
stäppflyghöna	s t ɛ p f l yː ɡ h øː n a
stäpphök	s t ɛ p h øː k
stäppsångare	s t ɛ p s ɔ ŋ a r ɛ
stäppvarg	s t ɛ˧˩ p ʋ a˥˩ r j
stäppvipa	s t ɛ p ʋ iː p a
stäppörn	s t ɛ p øː r n
stå	s t oː
stål	s t oː l
störa	s t œː r a
större	s t œ r eː
störtregn	s t ɵ ʈ r ɛ ŋ n
störtregn	s t ɶ ʈ r ɛ ŋ n
störtskur	s t ɵ ʈ s k ʉː r
störtskur	s t ɶ ʈ s k ʉː r
subjekt	s ɵ b j ɛ k t
subjektiv	s ɵ b j ɛ k t iː ʋ
substantiv	s ɵ b s t a n t iː ʋ
succé	s ʉː k s eː
suck	s ɵ k
sumpvipa	s ɵ m p ʋ iː p a
sund	s ɵ n d
supa	s ʉː p a
super	s ʉː˧˩ p ɛ˥˩ r
supinum	s ɵ p iː n ɵ m
sur	s ʉː r
sura	s ʉː r a
surpuppa	s ʉː˧˩ r p ɵ˥˩ p a
surströmming	s ʉː r s t r œ m ɪ ŋ
svan	s ʋ ɑː n
svans	s ʋ a n s
svans	s ʋ ɑː n s
svansrem	s ʋ a n s r ɛ m
svar	s ʋ ɑː r
svara	s ʋ ɑː r a
svart	s ʋ a˥˧ r t
svartand	s ʋ a ʈ a n d
svarthakedopping	s ʋ a ʈ h ɑː k ɛ d ɔ p ɪ ŋ
svartis	s ʋ a˥˧ r t ɪ˩ s
svartis	s ʋ a˧˩ r t iː˥˩ s
svartkråka	s ʋ a r t k r oː k a
svartpeppar	s ʋ a ʈ p ɛ p a r
svartsenap	s ʋ a ʈ s eː n a p
svartsnäppa	s ʋ a r t s n ɛ p a
svarttärna	s ʋ a r t t æː r n a
svarv	s ʋ a r ʋ
svavel	s ʋ ɑː ʋ ɛ l
sveg	s ʋ eː ɡ
sven	s ʋ eː n
sven	s ʋ ɛ n
svensk	s ʋ ɛ n s k
svenska	s ʋ ɛ˧˩ n s k a˥˩
svenskjävel	s ʋ ɛ n s k j ɛː ʋ ɛ l
sverige	s ʋ æ˥˧ r j ɛ˩
svika	s ʋ iː k a
svit	s ʋ iː t
svor	s ʋ uː r
svärd	s ʋ æː r d
svärta	s ʋ ɛ ʈ a
svåger	s ʋ oː ɡ ɛ r
svår	s ʋ oː˥˧ r
svårt	s ʋ oː ʈ
swisha	s w ɪ˧˩ ɕ a˥˩
swisha	s ʋ ɪ˧˩ ɕ a˥˩
syd	s yː d
sydafrikansk	s yː d a f r iː k aː n s k
sydkorea	s yː˧˩ d k ʊ˥˩ r eː a
sydsamiska	s yː d s ɑː m ɪ s k a
syl	s yː l
syll	s ʏ l
sylt	s ʏ l t
sylta	s ʏ l t a
sylvass	s yː l ʋ a s
symfoni	s ʏ m f ʊ n iː
symfoniorkester	s ʏ m f ʊ n iː ɔ r k ɛ s t ɛ r
syra	s yː r a
syrak	s yː r a k
syre	s yː r ɛ
syrra	s ʏ˧˩ r a˥˩
syssling	s ʏ˧˩ s l ɪ˥˩ ŋ
syssna	s ʏ˧˩ s n a˥˩
systemet	s ʏ s t eː˧˩ m ɛ˥˩ t
syster	s ʏ s t ɛ r
sädesfrö	s ɛː˧˩ d ɛ˥˩ s f r øː
sädgås	s ɛː d ɡ oː s
säga	s ɛ j a
sälg	s ɛ l j
sälja	s ɛː l j a
säljare	s ɛ l j a r eː
säll	s ɛ l
säng	s ɛ ŋ
sängram	s ɛ ŋ r ɑː m
säpo	s ɛː p ʊ
särbo	s ɛː r b ʊ
särbo	s ɛː˧˩ r b uː˥˩
särskild	s ɛː˧˩ r ɧ ɪ˥˩ l d
särskrivning	s ɛː˧˩ r s k r iː˥˩ ʋ n ɪ ŋ
sätt	s ɛ t
sävsångare	s ɛː ʋ s ɔ ŋ a r ɛ
så	s oː
såg	s oː ɡ
sågverk	s oː ɡ ʋ ɛ r k
sån	s oː n
sån	s ɔ n
sång	s ɔ ŋ
sångsvan	s ɔ ŋ s ʋ ɑː n
sånär	s ɔ n ɛː r
sås	s oː s
söder	s øː d ɛ r
södermanland	s øː d ɛ r m a n l a n d
södermanland	s œ r m l a n d
sökbar	s ø˧˩ k b ɑː˥˩ r
söm	s œ m
sömn	s œ m n
söndag	s œ n d a
söndag	s œ n d ɑː ɡ
söt	s øː t
sötebröd	s øː˧˩ t ɛ˥˩ b r øː d
sötebrödsdagar	s øː˧˩ t ɛ˥˩ b r øː d s d ɑː ɡ a r
sött	s œ t
söul	s øː ʉː l
t	t eː
ta	t ɑː
tabbe	t a b ɛ
tack	t a k
tag	t ɑː ɡ
taggstjärtseglare	t a ɡ ɧ ɛ ʈ s eː ɡ l a r ɛ
taiwanmes	t a j w a n m eː s
tajgasädgås	t a j ɡ a ɡ oː s
tajgasångare	t a j ɡ a s ɔ ŋ a r ɛ
tak	t ɑː k
tala	t ɑː l a
talang	t a l a ŋ
talko	t a l k ɔ
tall	t a l
tallbit	t a l b iː t
tallgråmes	t a l ɡ r oː m eː s
talong	t a l ɔ ŋ
tambur	t a m b ʉː r
tand	t a n d
tango	t a ŋ ɡ ʊ
tankesmedja	t a˧˩ ŋ k ɛ˥˩ s m eː d j a
tant	t a n t
tarzan	t a˥˧ ʂ a˩ n
tasse	t a˧˩ s ɛ˥˩
tassemark	t a˧˩ s ɛ˥˩ m a r k
tatarfalk	t a t ɑː r f a l k
tattare	t a t a r eː
te	t eː
telefon	t eː l eː f uː n
telefon	t ɛ l ɛ f oː n
telefon	t ɛ l ɛ f uː n
television	t ɛ l ɛ ʋ ɪ ɧ uː n
teoretiker	t ɛ ʊ r eː t ɪ k ɛ r
teoretisk	t ɛ ʊ r eː t ɪ s k
teori	t ɛ ʊ r iː
tepumla	t eː˧˩ p ɵ˥˩ m l a
terapeut	t æ r a p œ j t
terapeut	t æ r a p ɛː f t
terapeut	t æ r a p ɛː ʋ t
terapeutisk	t eː r a p eː f t ɪ s k
terbium	t ɛ r b ɪ ɵ m
tereksnäppa	t ɛ r ɛ k s n ɛ p a
teve	t eː ʋ eː
teve	t eː ʋ ɛ
therese	t ɛ r eː s
tid	t iː d
tiden	t iː d ɛ n
tiden	t iː n
tidning	t iː n ɪ ŋ
tiger	t iː˥˧ ɡ ɛ˩ r
till	t ɪ l
tillbaka	t ɪ l b ɑː k a
tillförordnad	t ɪ˧˩ l f œː˥˩ r oː r d n a d
tillhandahålla	t ɪ l h a˧˩ n d a˥˩ h ɔ l a
tills	t ɪ l s
tills	t ɪ s
tillsammans	t ɪ l s a˥˧ m a˩ n s
tillverkare	t ɪ˧˩ l ʋ ɛ˥˩ r k a r ɛ
timmar	t ɪ m a r
tina	t iː˧˩ n a˥˩
tio	t iː ɛ
tio	t iː ʊ
tionde	t iː ɔ n d ɛ
tisdag	t iː s d a
tisdag	t iː s d ɑː ɡ
titan	t ɪ t ɑː n
titel	t iː t ɛ l
titel	t ɪ t ɛ l
tivoli	t iː ʋ ɔ l iː
tivoli	t iː ʋ ʊ l iː
tivoli	t ɪ ʋ ɔ l iː
tivoli	t ɪ ʋ ʊ l iː
tja	t ɕ ɑː
tja	tɕ ɑː
tja	ɕ a
tjabba	ɕ a b a
tjalla	ɕ a˧˩ l a˥˩
tjeck	ɕ ɛ k
tjej	ɕ ɛ j
tjena	tɕ eː n ɑː
tjena	ɕ eː n a
tjenare	tɕ eː n ɑː r eː
tjenare	ɕ eː˧˩ n a˥˩ r ɛ
tjenixen	ɕ eː n ɪ k s ɛ n
tji	ɕ iː
tjock	ɕ ɔ k
tjockfot	ɧ ɔ k f uː t
tjog	ɕ oː ɡ
tjorre	ɕ ɔ˧˩ r ɛ˥˩
tjuga	ɕ ʉː ɡ a
tjugo	t ɕ ʉː ɡ ʉː
tjugo	t ɕ ʉː ɡ ʊ
tjugo	ɕ ɵ
tjugo	ɕ ʉː˧˩ ɡ ɛ˥˩
tjugo	ɕ ʉː˧˩ ɡ ɪ˥˩
tjugo	ɕ ʉː˧˩ ɡ ʊ˥˩
tjugonde	ɕ ʉː ɡ ɔ n d ɛ
tjugotredje	ɕ ʉː ɡ ʊ t r eː d j eː
tjur	ɕ ʉː r
tjuring	ɕ ʉː˧˩ r ɪ˥˩ ŋ
tjusa	ɕ ʉː˧˩ s a˥˩
tjuta	ɕ ʉː˧˩ t a˥˩
tjuv	ɕ ʉː ʋ
tjuvsena	ɕ ʉː ʋ s eː n a
tjänare	tɕ eː n ɑː r eː
tjänare	ɕ ɛː˧˩ n a˥˩ r ɛ
tjänare	ɛ n ɕ eː˧˩ n a˥˩ r ɛ
tjänixen	ɕ ɛ n ɪ k s ɛ n
tjära	ɕ ɛː r a
tjärn	ɕ ɛː r n
tjôta	ɕ œː˧˩ t a˥˩
tjöta	ɕ œː˧˩ t a˥˩
toalett	t uː a l ɛ t
tobisgrissla	t uː b ɪ s ɡ r ɪ s l a
toffelhjälte	t ɔ˧˩ f ɛ˥˩ l j ɛ l t ɛ
tofflor	t ɔ f l ʊ r
tofslunne	t ɔ f s l ɵ n ɛ
tofsvipa	t ɔ f s ʋ iː p a
tog	t uː ɡ
tok	t uː k
tolfte	t ɔ l f t ɛ
tolv	t ɔ l ʋ
tom	t oː m
tom	t uː m
tomte	t ɔ m t eː
tomten	t ɔ˥˧ m t ɛ˩ n
tomten	t ɔ˧˩ m t ɛ˥˩ n
ton	t uː n
ton	t ɔ n
tonartshöjning	t uː˧˩ n a˥˩ r t s h œ j n ɪ ŋ
toppskarv	t ɔ p s k a r ʋ
torg	t ɔ r j
torium	t uː r ɪ ɵ m
tornedalen	t oː r n ɛ d ɑː l ɛ n
tornedalsfinska	t oː r n ɛ d ɑː l s f ɪ n s k a
tornseglare	t uː ŋ s eː ɡ l a r ɛ
torsdag	t uː r s d a
torsdag	t uː r s d ɑː ɡ
toscakaka	t ɔ s k a k ɑː k a
total	t ʊ t ɑː l
tragedi	t r a ɧ ɛ d iː
trapp	t r a p
trast	t r a˥˧ s t
trastsångare	t r a s t s ɔ ŋ a r ɛ
tre	t r eː
tredje	t r eː d j ɛ
tremänning	t r eː˧˩ m ɛ˥˩ n ɪ ŋ
tretal	t r eː t ɑː l
trettio	t r ɛ˧˩ t ɪ˥˩
trettio	t r ɛ˧˩ t ɪ˥˩ ʊ
tretton	t r ɛ t ɔ n
triljard	t r ɪ l j ɑː r d
triljon	t r ɪ l j uː n
trivas	t r iː ʋ a s
trivsel	t r ɪ f s eː l
trivsel	t r ɪ ʋ s eː l
tro	t r uː
troca	t r ɔ˧˩ k a˥˩
troll	t r ɔ l
trolla	t r ɔ l a
tromsø	t r ʊ m s œ
tron	t r uː n
tror	t r uː r
trosa	t r uː s a
truga	t r ʉː ɡ a
trumpet	t r ɵ m p eː t
träd	t r ɛː d
trädgård	t r ɛː ɡ oː r d
trädgård	t r ɛː ɡ ɔ r d
trädmås	t r ɛ d m oː s
trädpiplärka	t r ɛ d p iː p l ɛ r k a
träldom	t r ɛː l d ʊ m
träna	t r ɛː n a
träna	t r ɛː˧˩ n a˥˩
tränga	t r ɛ ŋ a
tråd	t r oː d
tråg	t r oː ɡ
tsunami	t s ɵ n ɑː m ɪ
tsunami	t s ʉː n ɑː m ɪ
tuff	t ɵ f
tukan	t ɵ k ɑː n
tundrasnäppa	t ɵ n d r aː s n ɛ p a
tundravarg	t ɵ˧˩ n d r a˥˩ ʋ a r j
tung	t ɵ ŋ
tunga	t ɵ ŋ a
tungel	t ɵ ŋ ɛ l
turban	t ɵ r b ɑː n
turkestantörnskata	t ɵ r k ɛ s t ɑː n t øː r n s k ɑː t a
tusen	t ʉː s ɛ n
tuvsnäppa	t ʉː ʋ s n ɛ p a
tv	t eː ʋ eː
tv	t eː ʋ ɛ
tvedräkt	t ʋ eː˧˩ d r ɛ˥˩ k t
tveeggad	t ʋ eː˧˩ ɛ˥˩ ɡ a d
tvegifte	t ʋ eː˧˩ j ɪ˥˩ f t ɛ
tvehågsen	t ʋ eː˧˩ h oː˥˩ ɡ s ɛ n
tvehövdad	t ʋ eː˧˩ h œ˥˩ ʋ d a d
tvesovla	t ʋ eː˧˩ s oː˥˩ ʋ l a
tvestjärt	t ʋ eː˧˩ ɧ ɛ˥˩ r t
tvivla	t ʋ iː ʋ l a
tvärtom	t ʋ ɛː ʈ ɔ m
tvättbjörn	t ʋ ɛ t b j øː ɳ
tvätterska	t ʋ ɛ t ɛ ʂ k a
tvättmedel	t ʋ ɛ t m eː d ɛ l
två	t ʋ oː
tvång	t ʋ ɔ ŋ
tvångssvenska	t ʋ ɔ ŋ s s ʋ eː n s k ɑː
tvångssvenska	t ʋ ɔ˧˩ ŋ s s ʋ ɛ˥˩ n s k a
ty	t yː
tyg	t yː ɡ
tygelmes	t yː ɡ ɛ l m eː s
tygeltärna	t yː ɡ ɛ l t æː r n a
tykobrahedag	t ʏ k ʊ b r ɑː ɛ d ɑː ɡ
tyngst	t ʏ ŋ s t
tyska	t ʏ˧˩ s k a˥˩
tyskland	t ʏ s k l a n d
tyst	t ʏ s t
tzatziki	t s a t s iː k ɪ
täcke	t ɛ˧˩ k ɛ˥˩
täckt	t ɛ k t
täkt	t ɛ k t
tända	t ɛ˧˩ n d a˥˩
tänkte	t ɛ ŋ k t ɛ
tärnmås	t ɛː r n m oː s
tåg	t oː ɡ
töras	t øː r a s
törnskata	t øː r n s k ɑː t a
u	ɵ
u	ʉː
uefa	ɵ eː˧˩ f a˥˩
uer	ʉː ɛ r
ugn	ɵ ŋ n
ukulele	ɵ k ɵ l eː l ɛ
ull	ɵ l
ulla	ɵ˧˩ l a˥˩
ulrika	ɵ l r iː˧˩ k a˥˩
ulv	ɵ l ʋ
ung	ɵ ŋ
ungefär	ɵ n j eː f æː r
ungefär	ɵ n j eː f ɛː r
ungefär	ɵ ŋ eː f ɛː r
ungefär	ɵ ŋ j ɛ f æː r
ungefär	ɵ ŋ ɛ f æː r
universitet	ɵ n ɪ ʋ ɛ ʂ ɪ t eː t
upp	ɵ p
upprätt	ɵ˧˩ p r ɛ˥˩ t
upprätthålla	ɵ˧˩ p r ɛ˥˩ t h ɔ l a
uppsala	ɵ p s ɑː l a
uppsaliensisk	ɵ p s a l ɪ ɛ n s ɪ s k
uppstyrdhet	ɵ˧˩ p s t yː˥˩ r d h eː t
uppträda	ɵ p t r ɛː d a
uppträdande	ɵ p t r ɛː d a n d eː
uppvisning	ɵ˧˩ p ʋ iː˥˩ s n ɪ ŋ
uppå	ɵ˥˧ p oː˩
uppå	ɵ˧˩ p oː˥˩
ur	ʉː r
uran	ɵ r ɑː n
uranus	ɵ r ɑː n ɵ s
urgammal	ɵ r ɡ a m a l
ursäkta	ʉː r s ɛ k t a
ursäkta	ʉː ʂ ɛ k t a
usa	ʉː ɛ s ɑː
usch	ɵ ɧ
usel	ʉː s ɛ l
ut	ʉː t
utan	ʉː t a n
utanför	ʉː˧˩ t a˥˩ n f œː r
utbrott	ʉː t b r ɔ t
utgång	ʉː t ɡ ɔ ŋ
utom	ʉː˧˩ t ɔ˥˩ m
utslag	ʉː t s l ɑː ɡ
uttryck	ʉː t t r ʏ k
uv	ʉː ʋ
uzbek	ɵ s b eː k
va	ʋ a
va	ʋ ɑː
vabba	ʋ a˧˩ b a˥˩
vaccin	ʋ a k s iː n
vacker	ʋ a k ɛ r
vad	ʋ ɑː d
vadstena	ʋ a s t eː n a
vagnmakare	ʋ a ŋ n m ɑː k a r ɛ
vaj	ʋ a j
vaja	ʋ a˧˩ j a˥˩
vajsing	ʋ a˧˩ j s ɪ˥˩ ŋ
vakna	ʋ ɑː k n a
vakta	ʋ a˧˩ k t a˥˩
val	ʋ ɑː l
valack	ʋ a l a k
valacka	ʋ a l a k a
valfläsk	ʋ ɑː l f l ɛ s k
valk	ʋ a l k
valka	ʋ a˧˩ l k a˥˩
valkning	ʋ a˧˩ l k n ɪ˥˩ ŋ
valsverk	ʋ a l s ʋ ɛ r k
vampyr	ʋ a m p yː r
vandrare	ʋ a n d r a r ɛ
vandringsord	ʋ a n d r ɪ ŋ s uː r d
vann	ʋ a n
vapen	ʋ ɑː˥˧ p ɛ˩ n
var	ʋ ɑː r
vara	ʋ ɑː
vara	ʋ ɑː r a
varandra	ʋ a r a n d r a
varann	ʋ a r a n
varest	ʋ ɑː r ɛ s t
varfågel	ʋ ɑː r f oː ɡ ɛ l
varför	ʋ a˥˧ r f œ˩ r
varför	ʋ ɑː˥˧ r f œ˩ r
varg	ʋ a r j
vargatid	ʋ a˧˩ r j a˥˩ t iː d
vargavinter	ʋ a˧˩ r j a˥˩ ʋ ɪ n t ɛ r
vargaväder	ʋ a˧˩ r j a˥˩ ʋ ɛː d ɛ r
vargbiten	ʋ a˧˩ r j b iː˥˩ t ɛ n
vargflock	ʋ a˧˩ r j f l ɔ˥˩ k
varggrin	ʋ a˧˩ r j ɡ r iː˥˩ n
varggrop	ʋ a˧˩ r j ɡ r uː˥˩ p
varghagel	ʋ a˧˩ r j h ɑː˥˩ ɡ ɛ l
varghund	ʋ a˧˩ r j h ɵ˥˩ n d
varginna	ʋ a˧˩ r j ɪ˥˩ n a
vargjakt	ʋ a˧˩ r j j a˥˩ k t
vargpar	ʋ a˧˩ r j p ɑː˥˩ r
vargpäls	ʋ a˧˩ r j p ɛ˥˩ l s
vargrevir	ʋ a˧˩ r j r ɛ˥˩ ʋ iː r
vargskinn	ʋ a˧˩ r j ɧ ɪ˥˩ n
vargspår	ʋ a˧˩ r j s p oː˥˩ r
vargstam	ʋ a˧˩ r j s t a˥˩ m
vargtimma	ʋ a˧˩ r j t ɪ˥˩ m a
vargtimme	ʋ a˧˩ r j t ɪ˥˩ m eː
vargtjut	ʋ a˧˩ r j ɕ ʉː˥˩ t
vargton	ʋ a˧˩ r j t uː˥˩ n
vargunge	ʋ a˧˩ r j ɵ˥˩ ŋ ɛ
vargvalp	ʋ a˧˩ r j ʋ a˥˩ l p
varit	ʋ a ʈ
varit	ʋ ɑː r ɪ t
varit	ʋ ɑː ʈ
varken	ʋ a r k ɛ n
varm	ʋ a r m
varmt	ʋ a r m t
vars	ʋ a r s
vars	ʋ ɑː r s
varsågod	ʋ ɑː r s ɔ ɡ uː d
vart	ʋ a r t
vart	ʋ ɑː r t
varv	ʋ a r ʋ
vas	ʋ ɑː s
vasa	ʋ a s ɑː
vass	ʋ a s
vatten	ʋ a t ɛ n
vattenrall	ʋ a t ɛ n r a l
vattensångare	ʋ a t ɛ n s ɔ ŋ a r ɛ
vattentorn	ʋ a t ɛ n t ɵː ɳ
vattnen	ʋ a t n ɛ n
vattnet	ʋ a t n ɛ t
ve	ʋ eː
vecka	ʋ ɛ˧˩ k a˥˩
vek	ʋ eː k
velociped	ʋ ɛ l ɔ s ɪ p eː d
velociped	ʋ ɛ l ʊ s ɪ p eː d
venus	ʋ eː n ɵ s
verk	ʋ æ r k
verka	ʋ ɛ r k a
verklighetsflykt	ʋ ɛ˧˩ r k l ɪ˥˩ ɡ h eː t s f l ʏ k t
verkstad	ʋ eː r k s t a
vessla	ʋ ɛ s l a
veta	ʋ eː t a
vete	ʋ eː˧˩ t ɛ˥˩
vete	ʋ ɛ t ɛ
veteran	ʋ ɛ t ɛ r ɑː n
vetja	ʋ ɛ t j a
vi	ʋ iː
vid	ʋ iː d
vidareutbilda	ʋ iː d a r ɛ ʉː t b ɪ l d a
vidareutbildning	ʋ iː d a r ɛ ʉː t b ɪ l d n ɪ ŋ
videsångare	ʋ iː d ɛ s ɔ ŋ a r ɛ
vidskepelse	ʋ iː d ɧ eː p ɛ l s ɛ
vidskeplig	ʋ iː d ɧ eː p l ɪ ɡ
vigsel	ʋ ɪ˥˧ k s e˩ l
vilja	ʋ ɪ˧˩ l j a˥˩
vill	ʋ ɪ l
ville	ʋ ɪ l ɛ
vin	ʋ iː n
vind	ʋ ɪ n d
viner	ʋ iː˥˧ n ɛ˩ r
viner	ʋ iː˧˩ n ɛ˥˩ r
vinge	ʋ ɪ ŋ ɛ
vinter	ʋ ɪ n t ɛ r
vintertid	ʋ ɪ n t ɛ r t iː d
vintras	ʋ ɪ˧˩ n t r a˥˩ s
viol	ʋ ɪ uː l
viola	ʋ ɪ uː˧˩ l a˥˩
violinist	ʋ ɪ ʊ l ɪ n ɪ s t
vipa	ʋ iː p a
virre	ʋ ɪ˧˩ r ɛ˥˩
vischan	ʋ ɪ˧˩ ɧ a˥˩ n
vision	ʋ ɪ ɧ uː n
vismut	ʋ ɪ s m ɵ t
vit	ʋ iː t
vitgumpseglare	ʋ iː t ɡ ɵ m p s eː ɡ l a r ɛ
vitgumpsnäppa	ʋ iː t ɡ ɵ m p s n ɛ p a
vitrysk	ʋ iː˧˩ t r ʏ˥˩ s k
vitryska	ʋ iː˧˩ t r ʏ˥˩ s k a
vitsenap	ʋ iː t s eː n a p
vittrut	ʋ iː t t r ʉː t
volfram	ʋ ɔ l f r a m
volvo	ʋ ɔ l ʋ ʊ
vore	ʋ uː r ɛ
voss	ʋ ɔ s
vredesdom	ʋ r eː˧˩ d ɛ˥˩ s d ʊ m
vresig	ʋ r eː s ɪ ɡ
vuxen	ʋ ɵ k s ɛ n
vy	ʋ yː
väcka	ʋ ɛ˧˩ k a˥˩
väderprognos	ʋ ɛː d ɛ r p r ɔ ɡ n oː s
väg	ʋ ɛː ɡ
vägg	ʋ ɛ ɡ
vägra	ʋ ɛː˧˩ ɡ r a˥˩
väl	ʋ ɛ l
väl	ʋ ɛː l
välbehag	ʋ ɛː˧˩ l b ɛ˥˩ h ɑː ɡ
välja	ʋ ɛ l j a
välkommen	ʋ eː l k ɔ m ɛ n
vän	ʋ ɛ n
vän	ʋ ɛː n
vänlig	ʋ ɛː˧˩ n l ɪ˥˩ ɡ
vänlig	ʋ ɛ˧˩ n l ɪ˥˩ ɡ
vänta	ʋ ɛ n t a
väntan	ʋ ɛ˧˩ n t a˥˩ n
värd	ʋ ɛː ɖ
värde	ʋ ɛ˧˩ r d ɛ˥˩
värdeavi	ʋ ɛ r d ɛ a ʋ iː
värden	ʋ æː ɖ ɛ n
värdighet	ʋ ɛː r d ɪ ɡ h eː t
värld	ʋ ɛː r d
världen	ʋ æː ɖ ɛ n
världens	ʋ æː ɖ ɛ n s
värmlandskorv	ʋ ɛ˧˩ r m l a˥˩ n d s k ɔ r ʋ
väster	ʋ ɛ s t ɛ r
västgöte	ʋ ɛ s t j øː t ɛ
västgöte	ʋ ɛ ɧ œ t ɛ
västgötska	ʋ ɛ s t j øː t s k a
västgötska	ʋ ɛ ɧ œ t s k a
väte	ʋ ɛː t ɛ
väteperoxid	ʋ ɛː t ɛ p ɛ r ɔ k s iː d
växellåda	ʋ ɛ k s ɛ l l oː d a
växjö	ʋ ɛ k ɧ øː
växthus	ʋ ɛ k s t h ʉː s
våg	ʋ oː ɡ
vågform	ʋ oː ɡ f ɔ r m
vålnad	ʋ oː l n a d
vång	ʋ ɔ ŋ
vår	ʋ oː r
våradonis	ʋ oː r a d uː n ɪ s
våras	ʋ oː˧˩ r a˥˩ s
vård	ʋ oː ɖ
vårdslös	ʋ oː˧˩ r d s l øː˥˩ s
vårting	ʋ oː˧˩ r t ɪ˥˩ ŋ
vårting	ʋ oː˧˩ r ʈ ɪ˥˩ ŋ
vårtsvin	ʋ oː ʈ s ʋ iː n
våt	ʋ oː t
w	d ɵ b ɛ l ʋ eː
w	w
w	ʋ
weekend	w iː k ɛ n d
weekend	ʋ iː k ɛ n d
wiccan	w ɪ k a n
wiccan	ʋ ɪ k a n
wien	ʋ iː n
wiki	w iː k ɪ
wiki	w ɪ k ɪ
wiki	ʋ iː k ɪ
wiki	ʋ ɪ k ɪ
wilsonsimsnäppa	w ɪ l s ɔ n s ɪ m s n ɛ p a
xantippa	k s a n t ɪ˧˩ p a˥˩
yngla	ʏ˧˩ ŋ l a˥˩
yr	yː r
ystad	yː s t a
ystad	ʏ s t a d
yttrium	ʏ t r ɪ ɵ m
yvas	yː˧˩ ʋ a˥˩ s
z	s
z	s ɛː t a
ziggis	s ɪ ɡ ɪ s
zink	s ɪ n k
zombie	s ɔ m b ɪ
zon	s uː n
à	aː
ä	ɛ
ä	ɛː
äckelgubbe	ɛ k ɛ l ɡ ɵ b ɛ
äcklig	ɛ˧˩ k l ɪ˥˩ ɡ
äga	ɛː˧˩ ɡ a˥˩
ägg	ɛ ɡ
äggakaka	ɛ˧˩ ɡ a˥˩ k ɑː k a
äggtoddy	ɛ ɡ t ɔ d ʏ
äggula	ɛ ɡ ʉː l a
ägretthäger	ɛ ɡ r ɛ t h ɛ ɡ ɛ r
äldre	ɛ l d r ɛ
äldst	ɛ l s t
älg	ɛ l j
älgar	ɛ l j a r
älling	ɛ˧˩ l ɪ˥˩ ŋ
älska	ɛ l s k a
älta	ɛ l t a
älv	ɛ l ʋ
älva	ɛ l ʋ a
än	ɛ n
ända	ɛ n d a
ändelse	ɛ n d ɛ l s ɛ
ändå	ɛ n d oː
ändå	ɛ˧˩ n d oː˥˩
ändå	ɛ˧˩ n d ɔ˥˩
äng	ɛ ŋ
ängshök	ɛ ŋ s h øː k
ängspiplärka	ɛ ŋ s p iː p l ɛ r k a
änkestöt	ɛ ŋ k eː s t øː t
ännu	ɛ n ʉː
ännu	ɛ˧˩ n ɵ˥˩
äntligen	ɛ n t l ɪ ɡ ɛ n
äntligen	ɛ ŋ k l ɪ ɡ ɛ n
äppeljuice	æ p ɛ l j uː s
äpple	ɛ p l ɛ
äpplen	ɛ p l ɛ n
är	eː r
är	æː r
är	ɛː r
ära	æː˧˩ r a˥˩
ärla	æː r l a
ärlig	æː ɭ ɪ ɡ
ärt	æ ʈ
ät	ɛː t
äta	ɛː t a
äter	eː t ɛ r
å	oː
å	ɔ
åboensisk	oː b ʊ ɛ n s ɪ s k
åda	oː˧˩ d a˥˩
åke	oː k ɛ
ål	oː l
åland	oː l a n d
åland	oː l ɑː n d
ångmaskin	ɔ ŋ m a ɧ iː n
ångström	ɔ˧˩ ŋ s t r ø˥˩ m
ångström	ɔ˧˩ ŋ s t r œ˥˩ m
ånyo	ɔ n yː˧˩ ʊ˥˩
år	oː r
åren	oː r ɛ n
årlig	oː˧˩ ɭ ɪ˥˩ ɡ
årta	oː r t a
åsikt	oː s ɪ k t
åskblå	ɔ˧˩ s k b l oː˥˩
åstadkomma	oː˧˩ s t a˥˩ k ɔ m a
åt	oː t
åtta	ɔ t a
åttio	ɔ˧˩ t ɪ˥˩
åttio	ɔ˧˩ t ɪ˥˩ ʊ
åttonde	ɔ t ɔ n d ɛ
é	eː
ö	øː
ö	œ
ödmjukhet	øː d m j ʉː k h eː t
öga	øː ɡ a
ökenlöpare	œ k ɛ n l øː p a r ɛ
ökenpipare	øː k ɛ n p iː p a r ɛ
öknamn	œ k n a m n
öl	øː l
öm	œ m
öppen	œ˧˩ p ɛ˥˩ n
öppenhjärtig	œ˧˩ p ɛ˥˩ n j ɛ r t ɪ ɡ
öppenhjärtlig	œ˧˩ p ɛ˥˩ n j ɛ r t l ɪ ɡ
öra	øː r a
örhänge	øː r h ɛ ŋ ɛ
örn	œ r n
örnvråk	øː r n ʋ r oː k
öronsäl	øː r ɔ n s ɛː l
ös	øː s
ösregn	øː˩ s r ɛ ŋ n
öster	œ s t ɛ r
östersjön	ø˧˩ s t ɛ˥˩ r ɧ ø n
östersund	œ s t ɛ r s ɵ n d
östgöte	œ s t j øː t ɛ
östgöte	œ ɧ œ t ɛ
östgötska	œ s t j øː t s k a
östgötska	œ ɧ œ t s k a
över	øː ʋ æ r
överflöd	øː ʋ ɛ r f l øː d
ā	ɛ
ā	ɛː
ō	øː
ō	œ
